You awake on the white floor looking up into a blinding light source. You stand up and look around. You're in the gallery. The last thing you remember was visiting here to see your submitted piece. After you walked around for a while, you started to feel dizzy, and now here you are. One thing is for sure, though, you need to get out.

Escape the Gallery
An Interactive Fiction by Ryan
Release 1 / Serial number 180304 / Inform 7 build 6M62 (I6/v6.33 lib 6/12N) SD

east gallery
The eastern half of the gallery. The room is mostly bare, with the exception of a few paintings and a door that has been boarded up. The entire room is lit up, yet there is no discernable light source. The white walls and floor are so clean they make you feel uneasy. You see the rest of the gallery stretch off to the west

You can see a couch (on which is a silver coin), a band painting and a house painting here.

>x band painting
You see a painting of a bunch of rock band instruments. Looks like they're all scattered around a small room.

>x house painting
You see a painting of a house in the suburbs somewhere. Upon closer inspection, you can see lights and silhouettes in the windows of the house. Looks like a party.

It looks incredibly realistic, almost as if you could walk right into it...

>x house painting
You see a painting of a house in the suburbs somewhere. Upon closer inspection, you can see lights and silhouettes in the windows of the house. Looks like a party.

>x house painting
You see a painting of a house in the suburbs somewhere. Upon closer inspection, you can see lights and silhouettes in the windows of the house. Looks like a party.

>x painting
Which do you mean, the band painting or the house painting?

>x painting
Which do you mean, the band painting or the house painting?

>x house painting
You see a painting of a house in the suburbs somewhere. Upon closer inspection, you can see lights and silhouettes in the windows of the house. Looks like a party.

* * *

>x house painting
You see a painting of a house in the suburbs somewhere. Upon closer inspection, you can see lights and silhouettes in the windows of the house. Looks like a party.

It looks incredibly realistic, almost as if you could walk right into it...

>x band painting
You see a painting of a bunch of rock band instruments. Looks like they're all scattered around a small room.

It looks incredibly realistic, almost as if you could walk right into it...

* * *

>i
You are carrying:
  a gold coin

>take silver coin
Taken.

>x band painting
You see a painting of a bunch of rock band instruments. Looks like they're all scattered around a small room.

* * *

>x house painting
You see a painting of a house in the suburbs somewhere. Upon closer inspection, you can see lights and silhouettes in the windows of the house. Looks like a party.

It looks incredibly realistic, almost as if you could walk right into it...

>w
You can't go that way.

>e
You can't go that way.

* * *

>take silver coin
Taken.

>w
west gallery
The western half of the gallery is just as plain as the east. The only difference is that there is no visible exit from this room, just a bunch of canvases on the wall. The entire room is bright without a lightbulb in sight.

You can see a balet painting, an office painting and a blank canvas here.

>walk into office painting
That's not something you can enter.

>jump into office painting
You steel yourself and jump into the office painting. The world spins around you and you land with a hard thud on the ground.

Office Lounge
You jump into the painting, expecting to walk into some office break room with a vending machine. What immediately takes you by surprise is your own body, you have become the vending machine itself! The weirder part is that you can see yourself standing in front of you, trying to put a coin into the slot. You feel like you should accept the coin to help yourself on your journey

You can see a lounge door here.

I beg your pardon?

* * *

>yes
That was a rhetorical question.

>jump
You jump on the spot.

>enter office painting
That's not something you can enter.

* * *

>jump into office painting
You steel yourself and jump into the office painting. The world spins around you and you land with a hard thud on the ground.

Office Lounge
You jump into the painting, expecting to walk into some office break room with a vending machine. What immediately takes you by surprise is your own body, you have become the vending machine itself! The weirder part is that you can see yourself standing in front of you, trying to put a coin into the slot. You feel like you should accept the coin to help yourself on your journey

You can see a lounge door here.

>jump into exit door
You can't see any such thing.

>jump into lounge door
You watch yourself walk back to the gallery, and you're thankful to be back in your own body again.

west gallery
The western half of the gallery is just as plain as the east. The only difference is that there is no visible exit from this room, just a bunch of canvases on the wall. The entire room is bright without a lightbulb in sight.

You can see a balet painting, an office painting and a blank canvas here.

>enter office painting
That's not something you can enter.

* * *

>w
west gallery
The western half of the gallery is just as plain as the east. The only difference is that there is no visible exit from this room, just a bunch of canvases on the wall. The entire room is bright without a lightbulb in sight.

You can see a balet painting, an office painting and a blank canvas here.

>jump into office painting
You steel yourself and jump into the office painting. The world spins around you and you land with a hard thud on the ground.

Office Lounge
You jump into the painting, expecting to walk into some office break room with a vending machine. What immediately takes you by surprise is your own body, you have become the vending machine itself! The weirder part is that you can see yourself standing in front of you, trying to put a coin into the slot. You feel like you should accept the coin to help yourself on your journey

You can see a lounge door and a rack (closed and empty) here.

>take drum sticks
The racks isn't open.

* * *

I beg your pardon?

>reject gold coin
You can't see any such thing.

>x drum sticks
I care not to know why, of all things, these wooden sticks managed to enter my inventory.

>i
You are carrying:
  a Drum Sticks
  a silver coin

* * *

I beg your pardon?

>jump into lounge door
You watch yourself walk back to the gallery, and you're thankful to be back in your own body again.

west gallery
The western half of the gallery is just as plain as the east. The only difference is that there is no visible exit from this room, just a bunch of canvases on the wall. The entire room is bright without a lightbulb in sight.

You can see a balet painting, an office painting and a blank canvas here.

>i
You are carrying:
  a Paint Can
  a Drum Sticks

* * *

>accept gold coin
You take the gold coin and watch as the drum sticks fall into the collection tray. You watch "yourself" pick them up and put them in your pocket

>accept silver coin
you take the gold coin and watch the paint can fall into the colleciton tray. Lucky it didn't spill. You watch "yourself" pick up the can"

>jump into lounge door
You watch yourself walk back to the gallery, and you're thankful to be back in your own body again.

west gallery
The western half of the gallery is just as plain as the east. The only difference is that there is no visible exit from this room, just a bunch of canvases on the wall. The entire room is bright without a lightbulb in sight.

You can see a balet painting, an office painting and a blank canvas here.

>e
east gallery
The eastern half of the gallery. The room is mostly bare, with the exception of a few paintings and a door that has been boarded up. The entire room is lit up, yet there is no discernable light source. The white walls and floor are so clean they make you feel uneasy.

You can see a couch, a band painting and a house painting here.

>jump into band painting
You get yourself psyched up and jump into the band painting. You feel like you just got off of a rollercoaster when your feet slam onto the ground.

Green Room
As you walk into the Green Room, you look down to see yourself wearing different clothes than you were before. These are much more expensive, and not really your style, but they look good. You are backstage before the big show. You're a rocker, evidently.

You can see a green door, an annoying groupie, a book, a guitar, a bass, a piano and a drum set here.

>play drum set
Thank God she doesn't like noise, and that you are clearly illiterate on the drums. She actually gets pretty mad and pulls a pair of shoes out of her bag and throws them at you before storming out of the room.

>take shoes
Taken.

>jump into green door
You turn and walk out of the green room. A familiar dizzyness hits you as you appear once again in the gallery.

east gallery
The eastern half of the gallery. The room is mostly bare, with the exception of a few paintings and a door that has been boarded up. The entire room is lit up, yet there is no discernable light source. The white walls and floor are so clean they make you feel uneasy.

You can see a couch, a band painting and a house painting here.

* * *

>take coin
(the silver coin)
Taken.

>w
west gallery
The western half of the gallery is just as plain as the east. The only difference is that there is no visible exit from this room, just a bunch of canvases on the wall. The entire room is bright without a lightbulb in sight.

You can see a balet painting, an office painting and a blank canvas here.

>jump into office painting
You steel yourself and jump into the office painting. The world spins around you and you land with a hard thud on the ground.

Office Lounge
You jump into the painting, expecting to walk into some office break room with a vending machine. What immediately takes you by surprise is your own body, you have become the vending machine itself! The weirder part is that you can see yourself standing in front of you, trying to put a coin into the slot. You feel like you should accept the coin to help yourself on your journey

You can see a lounge door here.

>take Drum Sticks
You can't see any such thing.

>take drum sticks
You can't see any such thing.

* * *

>take coin
(the silver coin)
Taken.

>e
You can't go that way.

>w
west gallery
The western half of the gallery is just as plain as the east. The only difference is that there is no visible exit from this room, just a bunch of canvases on the wall. The entire room is bright without a lightbulb in sight. You can see the rest of the gallery stretch off to the east.

You can see a ballet painting, an office painting and a blank canvas here.

>walk into office painting
You steel yourself and jump into the office painting. The world spins around you and you land with a hard thud on the ground.

Office Lounge
You jump into the painting, expecting to walk into some office break room with a vending machine. What immediately takes you by surprise is your own body, you have become the vending machine itself! The weirder part is that you can see yourself standing in front of you, trying to put a coin into the slot. You feel like you should accept the coin to help yourself on your journey.

You can see a lounge door and a rack (closed and empty) here.

>accept silver coin
you take the silver coin and watch the paint can fall into the colleciton tray. Lucky it didn't spill. You watch "yourself" pick up the can"

>accept gold coin
You take the gold coin and watch as the drum sticks fall into the collection tray. You watch "yourself" pick them up and put them in your pocket

>walk into lounge door
You watch yourself walk back to the gallery, and you're thankful to be back in your own body again.

west gallery
The western half of the gallery is just as plain as the east. The only difference is that there is no visible exit from this room, just a bunch of canvases on the wall. The entire room is bright without a lightbulb in sight. You can see the rest of the gallery stretch off to the east.

You can see a ballet painting, an office painting and a blank canvas here.

>e
east gallery
The eastern half of the gallery. The room is mostly bare, with the exception of a few paintings and a door that has been boarded up. The entire room is lit up, yet there is no discernable light source. The white walls and floor are so clean they make you feel uneasy. You see the rest of the gallery stretch off to the west

You can see a couch, a band painting and a house painting here.

>walk into band painting
You get yourself psyched up and jump into the band painting. You feel like you just got off of a rollercoaster when your feet slam onto the ground.

Green Room
As you walk into the Green Room, you look down to see yourself wearing different clothes than you were before. These are much more expensive, and not really your style, but they look good. You are backstage before the big show. You're a rocker, evidently.

You can see a green door, an annoying groupie, a book, a guitar, a bass, a piano and a drum set here.

>play drums
Thank God she doesn't like noise, and that you are clearly illiterate on the drums. She actually gets pretty mad and pulls a pair of shoes out of her bag and throws them at you before storming out of the room.

>take shoes
Taken.

>wear shoes
You put on the ballet shoes.

>take off shoes
You take off the ballet shoes.

>walk out of green door
I only understood you as far as wanting to walk outside.

>walk into green door
You turn and walk out of the green room. A familiar dizzyness hits you as you appear once again in the gallery.

east gallery
The eastern half of the gallery. The room is mostly bare, with the exception of a few paintings and a door that has been boarded up. The entire room is lit up, yet there is no discernable light source. The white walls and floor are so clean they make you feel uneasy. You see the rest of the gallery stretch off to the west

You can see a couch, a band painting and a house painting here.

>w
west gallery
The western half of the gallery is just as plain as the east. The only difference is that there is no visible exit from this room, just a bunch of canvases on the wall. The entire room is bright without a lightbulb in sight. You can see the rest of the gallery stretch off to the east.

You can see a ballet painting, an office painting and a blank canvas here.

>enter ballet painting
You take a moment to compose yourself and jump into the ballet painting. The world fades around you and you feel like you're spinning as your feet hit the ground.

ballet studio
The wall is lined with mirrors, and there are a few bars along the wall, likely for practice and balance. You catch a glimpse of yourself, and you see yourself wearing different clothes than before. You wear a one piece, skin-tight costume with glittery makeup and an unidentifiable accessory in your hair. Strangely enough, however, you are not wearing any shoes. You see a stage door off to the east, and you figure that it's almost showtime.

You can see a studio door here.

>i
You are carrying:
  a ballet shoes
  a Drum Sticks
  a Paint Can

>e
You wouldn't dare go out on stage without your ballet shoes! Now where did they go...

>wear shoes
You put on the ballet shoes.

>e
You put on the pointed shoes and walk out onto the stage, greeted by an adoring crowd. Music starts to play, and you begin to dance. You don't remember taking any ballet lessons, but you move with the elegance and grace of someone that has practiced for years. It might be the shoes, or the painting, but as the music ends the crowd erupts into cheers. You catch a rose thrown from the audience and return back to the studio. You take off your shoes and toss them to the side.

>i
You are carrying:
  a rose
  a Drum Sticks
  a Paint Can

>enter studio door
You leave the ballet studio, and you resist the urge to fall over as you appear back in the gallery.

west gallery
The western half of the gallery is just as plain as the east. The only difference is that there is no visible exit from this room, just a bunch of canvases on the wall. The entire room is bright without a lightbulb in sight. You can see the rest of the gallery stretch off to the east.

You can see a ballet painting, an office painting and a blank canvas here.

>x blank canvas
At the end of the gallery, you see an entirely blank canvas. You can't tell if this was a mistake, or if someone submitted it as an abstract statement on the subjectivity of art. Either way, it seems pretty out of place. Maybe you could paint something on here, if you had the proper tools.

>paint blank canvas
It's going to be a little difficult to do anything without a paintbrush and paint.

>walk into exit painting
You can't see any such thing.

>undo
west gallery
[Previous turn undone.]

>i
You are carrying:
  a rose
  a Drum Sticks
  a Paint Can

>paint blank canvas
It's going to be a little difficult to do anything without a paintbrush and paint.

* * *

>x couch
A small two cushion couch for patrons to sit on while they admire and contemplate the art pieces.

On the couch is a silver coin.

>x silver coin
A tarnished silver coin. You found this on the couch in the gallery.

>take silver coin
Taken.

>x paintings
You can't see any such thing.

>x painting
Which do you mean, the band painting or the house painting?

>x band painting
You see a painting of a bunch of rock band instruments. Looks like they're all scattered around a small room.

>take painting
Which do you mean, the band painting or the house painting?

>take band painting
Taken.

>drop band painting
Dropped.

>enter band painting
That's not something you can enter.

>enter house painting
That's not something you can enter.

>x door
You can't see any such thing.

>x house painting
You see a painting of a bunch of people at what looks to be a house party. There are groups of people talking, an open bar, and a couple passionately kissing in the back corner.

It looks incredibly realistic, almost as if you could jump right into it...

>jump into house painting
You take a deep breath and jump into the house painting. The silence of the gallery fades into loud conversation and music as your feet hit the ground.

house party
You're in the painted room of revellers and lovers, and the feeling all around you changes. There's an allure, a secret seduction. The whispers of the painted figures here brush over you like smoke. Just beyond, you see a living space the size of a classroom, furnished with elegant brown leather couches and chaises, tapestries in scarlet and gold, and thick rugs. On the right side of the room is a finished oak bar, where a mustached bartender pours dark red wine out for a naked man sitting slumped, wearing a towel as a cape.  It's the painting from the lobby, except you sense something is missing. You recall the missing detail. In the far corner a woman traces her finger idly over a parchment-colored globe the size of a beach ball. She was supposed to be with someone, locked in a sensual kiss, arms crossed over the shoulders of the missing person with a rose between two fingers like a cigarette.

You can see a house door here.

>x classroom
You can't see any such thing.

>x couchres
You can't see any such thing.

>x couches
You can't see any such thing.

>x brown couch
You can't see any such thing.

>x bar
You can't see any such thing.

>jump out of house painting
I only understood you as far as wanting to jump.

>exit house painting
I only understood you as far as wanting to exit.

>n
You can't go that way.

>e
You can't go that way.

>w
You can't go that way.

>s
You can't go that way.

>down
You can't go that way.

>up
You can't go that way.

>look
house party
You're in the painted room of revellers and lovers, and the feeling all around you changes. There's an allure, a secret seduction. The whispers of the painted figures here brush over you like smoke. Just beyond, you see a living space the size of a classroom, furnished with elegant brown leather couches and chaises, tapestries in scarlet and gold, and thick rugs. On the right side of the room is a finished oak bar, where a mustached bartender pours dark red wine out for a naked man sitting slumped, wearing a towel as a cape.  It's the painting from the lobby, except you sense something is missing. You recall the missing detail. In the far corner a woman traces her finger idly over a parchment-colored globe the size of a beach ball. She was supposed to be with someone, locked in a sensual kiss, arms crossed over the shoulders of the missing person with a rose between two fingers like a cigarette.

You can see a house door here.

>enter house door
That's not something you can enter.

>open house door
It isn't something you can open.

>jump out of house door
I only understood you as far as wanting to jump.

>go through house door
That's not something you can enter.

>x house door
You see that the exit to the room should probably lead outside, if not to a front hallway, but instead you see the gallery that you just came from.

It looks incredibly realistic, almost as if you could jump right into it...

>jump into house door
You walk out of the party, and as the silence hits you, you realize just how quiet the gallery actually is...

east gallery
The eastern half of the gallery. The room is mostly bare, with the exception of a few paintings and a door that has been boarded up. The entire room is lit up, yet there is no discernable light source. The white walls and floor are so clean they make you feel uneasy.

You can see a band painting, a couch and a house painting here.

>x couch
A small two cushion couch for patrons to sit on while they admire and contemplate the art pieces.

>enter couch
That's not something you can enter.

>sit on couch
That's not something you can sit down on.

>x band painting
You see a painting of a bunch of rock band instruments. Looks like they're all scattered around a small room.

It looks incredibly realistic, almost as if you could jump right into it...

>jump into band painting
You get yourself psyched up and jump into the band painting. You feel like you just got off of a rollercoaster when your feet slam onto the ground.

Green Room
As you walk into the Green Room, you look down to see yourself wearing different clothes than you were before. These are much more expensive, and not really your style, but they look good. You are backstage before the big show. You're a rocker, evidently.

You can see a green door, an annoying groupie, a book, a guitar, a bass, a piano and a drum set here.

>take guitar
Taken.

>play guitar
*** Man, you really did it this time. She loved what she heard so much that she mothered two of your children. Nice going... 
 IF ONLY YOU PLAYED SOMETHING ELSE. ***

Would you like to RESTART, RESTORE a saved game, QUIT or UNDO the last command?

>undo
Green Room
[Previous turn undone.]

>play bass
Smart move trying to bore her with the bass. But you play it like Flea which is undoubtedly too cool for her to leave! 
 IF ONLY YOU HAD PLAYED SOMETHING ELSE.

>play drum set
It's going to be pretty hard to play drums without any drumsticks.

Thank God she doesn't like noise, and that you are clearly illiterate on the drums. She actually gets pretty mad and pulls a pair of shoes out of her bag and throws them at you before storming out of the room.

>x annoying groupie
You can't see any such thing.

>x annoying groupie
You can't see any such thing.

>talk to annoying groupie
That's not a verb I recognise.

>x green door
You look to the exit of the green room, but instead of seeing a stage or theater, you see the gallery that you just left.

It looks incredibly realistic, almost as if you could jump right into it...

>jump into green door
You turn and walk out of the green room. A familiar dizzyness hits you as you appear once again in the gallery.

east gallery
The eastern half of the gallery. The room is mostly bare, with the exception of a few paintings and a door that has been boarded up. The entire room is lit up, yet there is no discernable light source. The white walls and floor are so clean they make you feel uneasy.

You can see a band painting, a couch and a house painting here.

>n
You can't go that way.

>w
west gallery
The western half of the gallery is just as plain as the east. The only difference is that there is no visible exit from this room, just a bunch of canvases on the wall. The entire room is bright without a lightbulb in sight.

You can see a ballet painting, an office painting and a blank canvas here.

>x blank canvas
At the end of the gallery, you see an entirely blank canvas. You can't tell if this was a mistake, or if someone submitted it as an abstract statement on the subjectivity of art. Either way, it seems pretty out of place.

* * *

>x ballet painting
You see a painting of what you imagine to be a balet studio. It's a close up of a huge mirror, and there is a leg in a pointed shoe raised up onto a bar attached to the wall.

It looks incredibly realistic, almost as if you could jump right into it...

>jump into ballet painting
You take a moment to compose yourself and jump into the ballet painting. The world fades around you and you feel like you're spinning as your feet hit the ground.

ballet studio

>look
ballet studio

>undo
ballet studio
[Previous turn undone.]

>undo
west gallery
[Previous turn undone.]

>x office painting
This one's a little odd. You see what looks like an office break room in the picture. There is a coffee pot on the counter, a couple tables, and a vending machine. It's a little odd to see something like this in the gallery, but the craftsmanship is still incredible.

It looks incredibly realistic, almost as if you could jump right into it...

>jump into office painting
You steel yourself and jump into the office painting. The world spins around you and you land with a hard thud on the ground.

Office Lounge
You jump into the painting, expecting to walk into some office break room with a vending machine. What immediately takes you by surprise is your own body, you have become the vending machine itself! The weirder part is that you can see yourself standing in front of you, trying to put a coin into the slot. You feel like you should accept the coin to help yourself on your journey

You can see a lounge door and a rack (closed and empty) here.

>drop silver coin in machine
You can't see any such thing.

>drop silver coin
I realize I'm not a fan of the coin. I'm giving it back. I can tell it threw him off guard. He took his coin back and is presenting it to me yet again.

>take coin
(the silver coin)
Taken.

>accept coin
Which do you mean, the silver coin or the gold coin?

>accept gold coin
You take the gold coin and watch as the drum sticks fall into the collection tray. You watch "yourself" pick them up and put them in your pocket

* * *

>accept silver coin
you take the gold coin and watch the paint can fall into the colleciton tray. Lucky it didn't spill. You watch "yourself" pick up the can"

>accept coin
You can't see any such thing.

>drumsticks
That's not a verb I recognise.

>take drum sticks
What the, seriously? It's not my choice what I take. I just get stuffed with whatever my procastinator of a supplier fills me with. I might as well be a teddy bear. Hug me, please. I'm comfortable.

>x rack
The rack is empty.

>open rack
It seems to be locked.

>unlock rack
What do you want to unlock the rack with?

>key
You can't see any such thing.

>x lounge door
Instead of seeing the rest of the office through the door, you just see the rest of the gallery where you came from.

It looks incredibly realistic, almost as if you could jump right into it...

>jump into lounge door
You watch yourself walk back to the gallery, and you're thankful to be back in your own body again.

west gallery
The western half of the gallery is just as plain as the east. The only difference is that there is no visible exit from this room, just a bunch of canvases on the wall. The entire room is bright without a lightbulb in sight.

You can see a ballet painting, an office painting and a blank canvas here.

* * *

>take band painting
That's fixed in place.

>walk into band painting
That's not something you can enter.

* * *

>walk into band painting
That's not something you can enter.

* * *

>give gold coin to couch
You can only do that to something animate.

I beg your pardon?

>i
You are carrying:
  a gold coin

>e
You can't go that way.

* * *

>w
west gallery
The western half of the gallery is just as plain as the east. The only difference is that there is no visible exit from this room, just a bunch of canvases on the wall. The entire room is bright without a lightbulb in sight. You can see the rest of the gallery stretch off to the east.

You can see a ballet painting, an office painting and a blank canvas here.

>enter office painting
You steel yourself and jump into the office painting. The world spins around you and you land with a hard thud on the ground.

Office Lounge
You jump into the painting, expecting to walk into some office break room with a vending machine. What immediately takes you by surprise is your own body, you have become the vending machine itself! The weirder part is that you can see yourself standing in front of you, trying to put a coin into the slot. You feel like you should accept the coin to help yourself on your journey.

You can see a lounge door and a rack (closed and empty) here.

>accept gold coin
You take the gold coin and watch as the drum sticks fall into the collection tray. You watch "yourself" pick them up and put them in your pocket

>accept silver coin
You can't see any such thing.

>enter lounge door
You watch yourself walk back to the gallery, and you're thankful to be back in your own body again.

west gallery
The western half of the gallery is just as plain as the east. The only difference is that there is no visible exit from this room, just a bunch of canvases on the wall. The entire room is bright without a lightbulb in sight. You can see the rest of the gallery stretch off to the east.

You can see a ballet painting, an office painting and a blank canvas here.

>e
east gallery
The eastern half of the gallery. The room is mostly bare, with the exception of a few paintings and a door that has been boarded up. The entire room is lit up, yet there is no discernable light source. The white walls and floor are so clean they make you feel uneasy. You see the rest of the gallery stretch off to the west

You can see a couch (on which is a silver coin), a band painting and a house painting here.

>take silver coin
Taken.

>enter band painting
You get yourself psyched up and jump into the band painting. You feel like you just got off of a rollercoaster when your feet slam onto the ground.

Green Room
As you walk into the Green Room, you look down to see yourself wearing different clothes than you were before. These are much more expensive, and not really your style, but they look good. You are backstage before the big show. You're a rocker, evidently.

You can see a green door, an annoying groupie, a book, a guitar, a bass, a piano and a drum set here.

>play drums
Thank God she doesn't like noise, and that you are clearly illiterate on the drums. She actually gets pretty mad and pulls a pair of shoes out of her bag and throws them at you before storming out of the room.

* * *

>take shoes
Taken.

>enter green door
You turn and walk out of the green room. A familiar dizzyness hits you as you appear once again in the gallery.

east gallery
The eastern half of the gallery. The room is mostly bare, with the exception of a few paintings and a door that has been boarded up. The entire room is lit up, yet there is no discernable light source. The white walls and floor are so clean they make you feel uneasy. You see the rest of the gallery stretch off to the west

You can see a couch, a band painting and a house painting here.

>w
west gallery
The western half of the gallery is just as plain as the east. The only difference is that there is no visible exit from this room, just a bunch of canvases on the wall. The entire room is bright without a lightbulb in sight. You can see the rest of the gallery stretch off to the east.

You can see a ballet painting, an office painting and a blank canvas here.

* * *

>accept silver coin
you take the silver coin and watch the paint can fall into the colleciton tray. Lucky it didn't spill. You watch "yourself" pick up the can"

>i
You are carrying:
  a Paint Can
  a ballet shoes
  a Drum Sticks

>enter lounge door
You watch yourself walk back to the gallery, and you're thankful to be back in your own body again.

west gallery
The western half of the gallery is just as plain as the east. The only difference is that there is no visible exit from this room, just a bunch of canvases on the wall. The entire room is bright without a lightbulb in sight. You can see the rest of the gallery stretch off to the east.

You can see a ballet painting, an office painting and a blank canvas here.

>enter ballet painting
You take a moment to compose yourself and jump into the ballet painting. The world fades around you and you feel like you're spinning as your feet hit the ground.

ballet studio
The wall is lined with mirrors, and there are a few bars along the wall, likely for practice and balance. You catch a glimpse of yourself, and you see yourself wearing different clothes than before. You wear a one piece, skin-tight costume with glittery makeup and an unidentifiable accessory in your hair. Strangely enough, however, you are not wearing any shoes. You see a stage door off to the east, and you figure that it's almost showtime.

You can see a studio door here.

>e
You wouldn't dare go out on stage without your ballet shoes! Now where did they go...

* * *

>e
You put on the pointed shoes and walk out onto the stage, greeted by an adoring crowd. Music starts to play, and you begin to dance. You don't remember taking any ballet lessons, but you move with the elegance and grace of someone that has practiced for years. It might be the shoes, or the painting, but as the music ends the crowd erupts into cheers. You catch a rose thrown from the audience and return back to the studio. You take off your shoes and toss them to the side.

>i
You are carrying:
  a rose
  a Paint Can
  a Drum Sticks

>enter studio door
You leave the ballet studio, and you resist the urge to fall over as you appear back in the gallery.

west gallery
The western half of the gallery is just as plain as the east. The only difference is that there is no visible exit from this room, just a bunch of canvases on the wall. The entire room is bright without a lightbulb in sight. You can see the rest of the gallery stretch off to the east.

You can see a ballet painting, an office painting and a blank canvas here.

>e
east gallery
The eastern half of the gallery. The room is mostly bare, with the exception of a few paintings and a door that has been boarded up. The entire room is lit up, yet there is no discernable light source. The white walls and floor are so clean they make you feel uneasy. You see the rest of the gallery stretch off to the west

You can see a couch, a band painting and a house painting here.

>enter house painting
You take a deep breath and jump into the house painting. The silence of the gallery fades into loud conversation and music as your feet hit the ground.

house party
You're in the painted room of revellers and lovers, and the feeling all around you changes. There's an allure, a secret seduction. The whispers of the painted figures here brush over you like smoke. Just beyond, you see a living space the size of a classroom, furnished with elegant brown leather couches and chaises, and tapestries in scarlet and gold. On the right side of the room is a finished oak bar, where a naked man sits slumped, wearing a towel as a cape. It's the painting from the lobby, except you sense something is missing. You recall the missing detail. In the far corner a woman traces her finger idly over a parchment-colored globe the size of a beach ball. She was supposed to be with someone, locked in a sensual kiss, arms crossed over the shoulders of the missing person with a rose between two fingers like a cigarette. 
 You glance around the room and immediately notice a few people. You see the naked man sitting over at the bar, you see a shy woman off by the couch, running her finger over the rim of her glass, and you see a blonde woman mingling with other partygoers. 
 You also see the red haired woman over by the globe looking lonely.

You can see a house door, a couches, a bar, a tapestries, a naked man, a bartender, a shy woman, a blonde woman and a red haired woman here.

>x bar
A beautiful oak bar that runs along the right side of the room. Behind it you see a handsomely dressed bartender, currently cleaning a glass. At the bar you see a naked man, apparently passed out on the countertop.

>x naked man
You walk over to the bar and take a look at the naked man slumped over it. He is luckily wearing a towel around his neck, and it is folded over to cover the important parts. He looks like he is knocked out cold, best not disturb him.

>x bartender
You walk up to the bar and strike up a conversation wtih the bartender. He introduces himself as Joseph. 
 "Hey friend, what'll ya have?" 
 You reply that you don't want anything to drink, but you ask about the girl in the corner. 
 "Oh, her? That's Lila, she's been over there for a while now. To tell you the truth, I've been trying to work up the courage to talk to her all night, but I don't think it's my place. She does like flowers, though."

>give rose to bartender
You can only do that to something animate.

I beg your pardon?

>i
You are carrying:
  a rose
  a Paint Can
  a Drum Sticks

>give the rose to the bartender
You can only do that to something animate.

I beg your pardon?

>give rose
You walk up and strike up a conversation with Lila. Things are going well. You offer her the rose and she suddenly embraces you in a passionate kiss. Time seems to stop as you hold her. After the moment is over, she pulls away and puts the paintbrush into your hand. 
 "A little something to remember me by" 
 You walk back to the rest of the party, flustered, and unsure of exactly what just happened.

>i
You are carrying:
  a paintbrush
  a Paint Can
  a Drum Sticks

>enter house door
You walk out of the party, and as the silence hits you, you realize just how quiet the gallery actually is...

east gallery
The eastern half of the gallery. The room is mostly bare, with the exception of a few paintings and a door that has been boarded up. The entire room is lit up, yet there is no discernable light source. The white walls and floor are so clean they make you feel uneasy. You see the rest of the gallery stretch off to the west

You can see a couch, a band painting and a house painting here.

>w
west gallery
The western half of the gallery is just as plain as the east. The only difference is that there is no visible exit from this room, just a bunch of canvases on the wall. The entire room is bright without a lightbulb in sight. You can see the rest of the gallery stretch off to the east.

You can see a ballet painting, an office painting and a blank canvas here.

>paint blank canvas
Hey, it works for everything else in this gallery, right? You paint a picture of your own exit door onto the canvas. Honestly, it's pretty good, one of your better pieces. Now you have your very own exit painting.

>enter exit painting
*** You step into the painting that you created and walk out into the world. You've finally escaped the gallery, time to head home, you've got some new ideas for your next project after today! ***

Would you like to RESTART, RESTORE a saved game, QUIT or UNDO the last command?

>undo
west gallery
[Previous turn undone.]

>undo
west gallery
[Previous turn undone.]

>undo
east gallery
[Previous turn undone.]

>undo
house party
[Previous turn undone.]

>undo
house party
[Previous turn undone.]

>enter house door
You walk out of the party, and as the silence hits you, you realize just how quiet the gallery actually is...

east gallery
The eastern half of the gallery. The room is mostly bare, with the exception of a few paintings and a door that has been boarded up. The entire room is lit up, yet there is no discernable light source. The white walls and floor are so clean they make you feel uneasy. You see the rest of the gallery stretch off to the west

You can see a couch, a band painting and a house painting here.

>i
You are carrying:
  a rose
  a Paint Can
  a Drum Sticks

>w
west gallery
The western half of the gallery is just as plain as the east. The only difference is that there is no visible exit from this room, just a bunch of canvases on the wall. The entire room is bright without a lightbulb in sight. You can see the rest of the gallery stretch off to the east.

You can see a ballet painting, an office painting and a blank canvas here.

>paint blank canvas
It's going to be a little difficult to do anything without a paintbrush and paint.

>give rose
You'd rather hold onto that for now.

>offer rose
You'd rather hold onto that for now.

>give rose
You'd rather hold onto that for now.

>i
You are carrying:
  a rose
  a Paint Can
  a Drum Sticks

>give drum sticks
You'd rather hold onto that for now.

>e
east gallery
The eastern half of the gallery. The room is mostly bare, with the exception of a few paintings and a door that has been boarded up. The entire room is lit up, yet there is no discernable light source. The white walls and floor are so clean they make you feel uneasy. You see the rest of the gallery stretch off to the west

You can see a couch, a band painting and a house painting here.

* * *

>give rose
You walk up and strike up a conversation with Lila. Things are going well. You offer her the rose and she suddenly embraces you in a passionate kiss. Time seems to stop as you hold her. After the moment is over, she pulls away and puts the paintbrush into your hand. 
 "A little something to remember me by" 
 You walk back to the rest of the party, flustered, and unsure of exactly what just happened.

* * *

>i
You are carrying:
  a paintbrush
  a Paint Can
  a Drum Sticks

>give paintbrush
You'd rather hold onto that for now.