Test_Room
An Interactive Fiction by Rayn
Release 1 / Serial number 180131 / Inform 7 build 6M62 (I6/v6.33 lib 6/12N) SD

Living Space
You feel a sense of calm in here, and, oddly, the urge to think.

You can see a thinking-chair and a side table here.

>x thinking-chair
Ah, your thinking chair, theplace where you Think! Think! Thiiiiiinnnk!

>x side table
Your side table, the only place you trust yourself to keep your handy dandy notebook.

>x drawer
Aha! the handy dandy notebook! Now you can get down to business.

In the drawer is a handy dandy notebook.

* * *

Test_Room
An Interactive Fiction by Rayn
Release 1 / Serial number 180131 / Inform 7 build 6M62 (I6/v6.33 lib 6/12N) SD

Living Space
You feel a sense of calm in here, and, oddly, the urge to think.

You can see a thinking-chair and a side table here.

>x side table
Your side table, the only place you trust yourself to keep your handy dandy notebook. There is a small drawer on the side.

>open drawer
You open the drawer, revealing a handy dandy notebook.

>x handy dandy notebook
You see nothing special about the handy dandy notebook.

>x drawer
Aha! the handy dandy notebook! Now you can get down to business.

In the drawer is a handy dandy notebook.

>take handy dandy notebook
Taken.

>put handy dandy notebook on side table
You put the handy dandy notebook on the side table.

* * *

Test_Room
An Interactive Fiction by Rayn
Release 1 / Serial number 180131 / Inform 7 build 6M62 (I6/v6.33 lib 6/12N) SD

Living Space
You feel a sense of calm in here, and, oddly, the urge to think.

You can see a thinking-chair and a side table here.

>x thinking chair
You can't see any such thing.

>x thinking-chair
Ah, your thinking chair, theplace where you Think! Think! Thiiiiiinnnk!

>x side table
Your side table, the only place you trust yourself to keep your handy dandy notebook. There is a small drawer on the side.

* * *

>open drawer
You open the drawer, revealing a handy dandy notebook.

>x handy dandy notebook
Aha! the handy dandy notebook! Now you can get down to business.

>take handy dandy notebook
Taken.

>sit in thinking chair
You can't see any such thing.

>sit in thinking-chair
You get onto the thinking-chair.

>put handy dandy notebook on side table
You put the handy dandy notebook on the side table.