WARNING: This game is going to be difficult, and will likely require multiple playthroughs in order to reach a successful outcome, unless you are incredibly clever. You must learn from your mistakes in the past to secure the future. The game is afoot! 

You are Beth Davenport, an official at the Ministry of Transport, but that is not the important part of the story. You are out at a hotel on the south side of London, hoping to find a weary businessman to make the night less lonely, but your husband doesn't know that. You have been sitting at the bar for a few hours now, and with no prospects in sight, you are feeling that you might just be better off going home. You called a cab a few minutes ago, and it should be getting here in a few minutes.

The Pink Pill
An Interactive Fiction by Ryan
Release 1 / Serial number 180511 / Inform 7 build 6M62 (I6/v6.33 lib 6/12N) SD

Hotel Bar
The hotel bar on the first floor of some gaudy hotel that you have forgotten the name of. It's not important anyways. After all, you're not going to be paying for a room tonight. At least, that was your plan. Not many people here tonight, just the bartender and some lonely chairs. The exit is to the south.

You can see a television, a cocktail, a decorative bowl (in which is a matchbook) and a bartender here.

>i
You are carrying:
  a wedding ring The cell phone is a thing

>x ring
You see nothing special about the wedding ring The cell phone is a thing.

>x cocktail
Some fancy pink thing that you ordered about an hour ago, paid for with your hubby's credit card. It's not bad, just a bit sweet for your tastes.

>take cocktail
It would just be rude to take the drink and the glass with you when you leave, and you don't think the bartender will put it into a cup for you.

>take matchbook
Taken.

You look out the window of the bar and see a taxi pull up. Better not keep the cabby waiting.

>talk to bartender
You consider chatting up the bartender, but it's late, and you've essentially given up on your little escapade for tonight.

>take bartender
Tempting, but he's not really your type.

>i
You are carrying:
  a matchbook
  a wedding ring The cell phone is a thing

>s
You can't go that way.

>exit
But you aren't in anything at the moment.

The cabby honks outside, He's getting impatient.

>i
You are carrying:
  a matchbook
  a wedding ring The cell phone is a thing

>look
hotel bar
The hotel bar on the first floor of some gaudy hotel that you have forgotten the name of. It's not important anyways. After all, you're not going to be paying for a room tonight. At least, that was your plan. Not many people here tonight, just the bartender and some lonely chairs. The exit is to the south.

You can see a cocktail, a decorative bowl (empty) and a bartender here.

>s
You can't go that way.

>south
You can't go that way.

>n
You can't go that way.

The cabby lays on the horn, most drivers would have driven off by now, how kind that he waited for you to putz about the bar.

>e
You can't go that way.

>w
You can't go that way.

* * *

>s
You have no where to go. Better wait here until your cab arrives.

>take matchbook
Taken.

>talk to bartender
You consider chatting up the bartender, but it's late, and you've essentially given up on your little escapade for tonight.

* * *

>take bartender
Tempting, but he's not really your type.

>wait
Time passes.

You look out the window of the bar and see a taxi pull up. Better not keep the cabby waiting.

>s
Cab
A small cab, probably a couple decades old. The leather seats have peeled and been rubbed away, but they're more comfortable that way. The dashboard is mostly bare, except for a photo taped to the dash and a rosary hanging from the miror. You can see the back of the cabby's head through the glass, and his eyes through the rear mirror. There is a seat pocket in front of you.

You can see a photo, a rosary, a seat pocket (empty) and a cabby here.

You walk out of the bar and enter the cab. The driver doesn't turn around, but simply asks "Where to?" You give him your home address and sit back.

>s
You try the door but they are locked tight. Plus, jumping out of a moving car can't end well.

>talk to cabby
You don't really have much to say...

Its probably going to be a long cab ride.

>x photo
An old polaroid picturing three people: a woman and two children. You imagine that this must be the cabby's family.

>x rosary
A rosary, looks old.

The cabbies usually don't take this road. Oh well, maybe there was traffic on the way here.

>x seat pocket
A leather seat pocket attached to the seat in front of you.

>take seat pocket
That's fixed in place.

You're going completely the wrong way. You try to tell the cabby, but he doesn't say a word.

>take photo
The pane of plexiglass separates you from the front half of the cab.

>take polaroid
You can't see any such thing.

>take cabby
Even if you could, the glass is in the way.

>wait
Time passes.

You are starting to get very worried, the last street you recognized was three turns ago. You check your phone: no signal.

>wait
Time passes.

>wait
Time passes.

>call for help
That's not a verb I recognise.

>wait
Time passes.

The cabby drives out to a street with a few abandoned buildings and pulls over. Think, Beth, think! You can't get out of the cab, your phone has no signal, is there anything that you can do?

>wait
Time passes.

The cabby silently opens his side of the door, closes it, and opens the door on your side. You turn and kick him in the groin as soon as he opens the door. He doubles over for a moment, but recovers before you can strike again. 

 "Alright, we're going to have a little chat, you and I. But first," 

 With speed that you did not expect, the cabby pulls out a syringe and jabs you in the neck with it. It only takes a few seconds before your vision goes dark.

abandoned apartment
A musty old room that you assume once was a living area of someone's flat, but it has been abandoned for so long that the wood has rotted, and time has put holes in the roof. The state of the room, however is the least of your concerns. There is a murderer right in front of you.

* * *

>x cocktail
Some fancy pink thing that you ordered about an hour ago, paid for with your hubby's credit card. It's not bad, just a bit sweet for your tastes.

>x bowl
A small bowl that probably used to contain a bunch of matchbooks offered complimentary to patrons. Now there is only one book of matches left.

In the decorative bowl is a matchbook.

>take matchbook
Taken.

>x matchbook
A tiny book of matches with the hotel's name on the front, "The Easton." Used for advertising. You might want to go out for a smoke later.

>i
You are carrying:
  a matchbook
  a wedding ring
  a cell phone

You look out the window of the bar and see a taxi pull up. Better not keep the cabby waiting.

>x ring
Your wedding ring, though it doesn't mean much these days. You take it off enough that the inside looks almost polished. The inside of the ring is engraved with your and your husband's name.

>wear ring
You can't wear that!

>x phone
Your smartphone. You use this phone for everything, not the least of which is finding your way around. Only problem is that you lose it more often than you like. Luckily, you can track it from your computer back home, but it does make for some awkward conversations when your husband learns that your phone is halfway across the city. At least the password is easy to remember: it's the name of your daughter, Rachel.

>l
Hotel Bar
The hotel bar on the first floor of some gaudy hotel that you have forgotten the name of. It's not important anyways. After all, you're not going to be paying for a room tonight. At least, that was your plan. Not many people here tonight, just the bartender and some lonely chairs. The exit is to the south.

You can see a cocktail, a decorative bowl (empty) and a bartender here.

>x bartender
The bartender stands down the bar. He looks like he's cleaning up for the night, you're one of the last people here. You thought about chatting him up, but he's not really your type, and you're pretty sure he remembers you from the last time you were here.

The cabby honks outside, He's getting impatient.

>s
Cab
A small cab, probably a couple decades old. The leather seats have peeled and been rubbed away, but they're more comfortable that way. The dashboard is mostly bare, except for a photo taped to the dash and a rosary hanging from the miror. You can see the back of the cabby's head through the glass, and his eyes through the rear mirror. There is a seat pocket in front of you.

You can see a photo, a rosary, a seat pocket (empty) and a cabby here.

You walk out of the bar and enter the cab. The driver doesn't turn around, but simply asks "Where to?" You give him your home address and sit back.

>x photo
An old polaroid picturing three people: a woman and two children. You imagine that this must be the cabby's family.

>put matchbook in pocket
You put the matchbook into the seat pocket.

Its probably going to be a long cab ride.

>x rosary
A rosary, looks old.

>take photo
The pane of plexiglass separates you from the front half of the cab.

The cabbies usually don't take this road. Oh well, maybe there was traffic on the way here.

>x cabby
From the little you've seen of the cabby, he looks pretty old. He's got gray hair and a wool cap. You can see wrinkles on his face through the rear mirror.

>open phone
It isn't something you can open.

You're going completely the wrong way. You try to tell the cabby, but he doesn't say a word.

>x phone
Your smartphone. You use this phone for everything, not the least of which is finding your way around. Only problem is that you lose it more often than you like. Luckily, you can track it from your computer back home, but it does make for some awkward conversations when your husband learns that your phone is halfway across the city. At least the password is easy to remember: it's the name of your daughter, Rachel.

>use phone
I didn't understand that sentence.

>text hubby
I didn't understand that sentence.

>z
Time passes.

>z
Time passes.

You are starting to get very worried, the last street you recognized was three turns ago. You check your phone: no signal.

>z
Time passes.

>z
Time passes.

>z
Time passes.

The cabby drives out to a street with a few abandoned buildings and pulls over. Think, Beth, think! You can't get out of the cab, your phone has no signal, is there anything that you can do?

>i
You are carrying:
  a wedding ring
  a cell phone

The cabby silently opens his side of the door, closes it, and opens the door on your side. You turn and kick him in the groin as soon as he opens the door. He doubles over for a moment, but recovers before you can strike again. 

 "Alright, we're going to have a little chat, you and I. But first..." 

 With speed that you did not expect, the cabby pulls out a syringe and jabs you in the neck with it. It only takes a few seconds before your vision goes dark.

abandoned apartment
A musty old room that you assume once was a living area of someone's flat, but it has been abandoned for so long that the wood has rotted, and time has put holes in the roof. The state of the room, however is the least of your concerns. There is a murderer right in front of you.

The cabby sits in front of you. He seems eerily calm about the whole situation. 
 "Wake up, sleepyhead. I told ya that we was gonna have a little chat, so here we are. Don't worry, I didn't do nothing else to ya, sides the sleepin medicine. Now, you're Beth, yeah? Don't matter. After all, you're gonna be dead in a few minutes." 

 You ask if he is going to kill you here, and he chuckles. 

 "Naw, I'm just gonna talk to ya, and then you're gonna kill yourself."

>ask cabby why
You can only do that to something animate.

>x cabby
This is the psycho that kinapped you. He seems way too calm about this entire situation, like he's done this before.

>drop ring
Dropped.

The cabby seems to grow impatient. 
 "Now we're gonna play a little game, just the two of us. Look here, I got two bottles, each with a pill inside, identical in every way, cept one. One of the pills is harmless, and the other's got poison in it. I'm gonna put these bottles down, and you're gonna pick one, and take the pill inside, and I'll take the other, winner walks away alive." 

 He places the two identical bottles down onto the floor, and slides one toward you. 

 "Now, did I just give you the good bottle, or the bad bottle? I can tell you right now I'm gonna win, cause I know how people think. Now, make your move.

>x bottle
Which do you mean, the far bottle or the close bottle?

>close
(the cell phone)
It isn't something you can close.

>x close bottle
A small clear bottle with a pink pill inside. It looks identical to its counterpart.

>x far bottle
A small clear bottle with a pink pill inside. It looks identical to its counterpart.

>open far bottle
It isn't something you can open.

>take pill
You can't see any such thing.

>open close bottle
It isn't something you can open.

>take far bottle
You pick up the bottle farther away from you, open it, and take the pill inside. At the same time, the cabby takes the other bottle and takes that pill. A few moments pass, and the cabby begins to laugh hysterically. You double over in pain, and the cabby stands up and starts to leave the room. 

 "I told ya, I always win. Sorry, love, but it won't be long now" 

 Your vision blurs as you collapse to the ground. You realize that these are probably your last moments. Your thoughts race, and you try to think of something, anything you can do. You see your hands on the floor, your nails are pretty sharp. You could probably carve something into the soft wooden floor. Maybe you can stop this sick bastard after all.

What will you carve into the ground?

1) The killer's name.
2) Your daughter's name.
3) Your husband's name.

>1
[The killer's name.]

Of course! Writing the killer's name is a sure way to get them caught. You bring your hand onto the wood and realize that you never learned the name of the cabby. Not knowing what to write, you desperately try to think of something else, but your final breaths are spent in frustration, and nothing is written down.

>restart
Are you sure you want to restart?

>y
WARNING: This game is going to be difficult, and will likely require multiple playthroughs in order to reach a successful outcome, unless you are incredibly clever. You must learn from your mistakes in the past to secure the future. The game is afoot! 

You are Beth Davenport, an official at the Ministry of Transport, but that is not the important part of the story. You are out at a hotel on the south side of London, hoping to find a weary businessman to make the night less lonely, but your husband doesn't know that. You have been sitting at the bar for a few hours now, and with no prospects in sight, you are feeling that you might just be better off going home. You called a cab a few minutes ago, and it should be getting here in a few minutes.

The Pink Pill
An Interactive Fiction by Ryan
Release 1 / Serial number 180420 / Inform 7 build 6M62 (I6/v6.33 lib 6/12N) SD

Hotel Bar
The hotel bar on the first floor of some gaudy hotel that you have forgotten the name of. It's not important anyways. After all, you're not going to be paying for a room tonight. At least, that was your plan. Not many people here tonight, just the bartender and some lonely chairs. The exit is to the south.

You can see a cocktail, a decorative bowl (in which is a matchbook) and a bartender here.

>x cocktail
Some fancy pink thing that you ordered about an hour ago, paid for with your hubby's credit card. It's not bad, just a bit sweet for your tastes.

>x decorative bowl
A small bowl that probably used to contain a bunch of matchbooks offered complimentary to patrons. Now there is only one book of matches left.

In the decorative bowl is a matchbook.

>take matchbook
Taken.

>s
You have no where to go. Better wait here until your cab arrives.

>wait
Time passes.

You look out the window of the bar and see a taxi pull up. Better not keep the cabby waiting.

* * *

>x photot
You can't see any such thing.

>x photo
An old polaroid picturing three people: a woman and two children. You imagine that this must be the cabby's family.

>ask cabby
You can only do that to something animate.

>x seat pocket
A leather seat pocket attached to the seat in front of you.

Its probably going to be a long cab ride.

>x rosary
A rosary, looks old.

>take rosary
The pane of plexiglass separates you from the front half of the cab.

The cabbies usually don't take this road. Oh well, maybe there was traffic on the way here.

>wait
Time passes.

>look
Cab
A small cab, probably a couple decades old. The leather seats have peeled and been rubbed away, but they're more comfortable that way. The dashboard is mostly bare, except for a photo taped to the dash and a rosary hanging from the miror. You can see the back of the cabby's head through the glass, and his eyes through the rear mirror. There is a seat pocket in front of you.

You can see a photo, a rosary, a seat pocket (empty) and a cabby here.

You're going completely the wrong way. You try to tell the cabby, but he doesn't say a word.

>light matchbook
This dangerous act would achieve little.

>hit cabby
Violence isn't the answer to this one.

>scream
I didn't understand that sentence.

>yell
I didn't understand that sentence.

>wait
Time passes.

You are starting to get very worried, the last street you recognized was three turns ago. You check your phone: no signal.

>talk to cabby
You don't really have much to say...

>wait
Time passes.

>wait
Time passes.

The cabby drives out to a street with a few abandoned buildings and pulls over. Think, Beth, think! You can't get out of the cab, your phone has no signal, is there anything that you can do?

>light matchbook
This dangerous act would achieve little.

The cabby silently opens his side of the door, closes it, and opens the door on your side. You turn and kick him in the groin as soon as he opens the door. He doubles over for a moment, but recovers before you can strike again. 

 "Alright, we're going to have a little chat, you and I. But first..." 

 With speed that you did not expect, the cabby pulls out a syringe and jabs you in the neck with it. It only takes a few seconds before your vision goes dark.

abandoned apartment
A musty old room that you assume once was a living area of someone's flat, but it has been abandoned for so long that the wood has rotted, and time has put holes in the roof. The state of the room, however is the least of your concerns. There is a murderer right in front of you.

The cabby sits in front of you. He seems eerily calm about the whole situation. 
 "Wake up, sleepyhead. I told ya that we was gonna have a little chat, so here we are. Don't worry, I didn't do nothing else to ya, sides the sleepin medicine. Now, you're Beth, yeah? Don't matter. After all, you're gonna be dead in a few minutes." 

 You ask if he is going to kill you here, and he chuckles. 

 "Naw, I'm just gonna talk to ya, and then you're gonna kill yourself."

>wait
Time passes.

>talk
What do you want to talk to?

>talk to cabby
You question the cabby about his various motives and means of his kidnappings, but he either dodges the question, or just starts laughing.

The cabby seems to grow impatient. 
 "Now we're gonna play a little game, just the two of us. Look here, I got two bottles, each with a pill inside, identical in every way, cept one. One of the pills is harmless, and the other's got poison in it. I'm gonna put these bottles down, and you're gonna pick one, and take the pill inside, and I'll take the other, winner walks away alive." 

 He places the two identical bottles down onto the floor, and slides one toward you. 

 "Now, did I just give you the good bottle, or the bad bottle? I can tell you right now I'm gonna win, cause I know how people think. Now, make your move.

>x bottle
Which do you mean, the far bottle or the close bottle?

>x close bottle
A small clear bottle with a pink pill inside. It looks identical to its counterpart.

>run
You'll have to say which compass direction to go in.

>s
Surprisingly, the cabby lets you stand up and go try the exit. Naturally it's locked tight, and all the windows are boarded up.

>loo
I didn't understand that sentence.

>look
abandoned apartment
A musty old room that you assume once was a living area of someone's flat, but it has been abandoned for so long that the wood has rotted, and time has put holes in the roof. The state of the room, however is the least of your concerns. There is a murderer right in front of you.

You can see a far bottle, a close bottle and a cabby here.

>take close bottle
You pick up the bottle closer to you, open it, and take the pill inside. At the same time, the cabby takes the other bottle and takes that pill. A few moments pass, and the cabby begins to laugh hysterically. You double over in pain, and the cabby stands up and starts to leave the room. 

 "I told ya, I always win. Sorry, love, but it won't be long now" 

 Your vision blurs as you collapse to the ground. You realize that these are probably your last moments. Your thoughts race, and you try to think of something, anything you can do. You see your hands on the floor, your nails are pretty sharp. You could probably carve something into the soft wooden floor. Maybe you can stop this sick bastard after all.

What will you carve into the ground?

1) The killer's name.
2) Your daughter's name.
3) Your husband's name.

>1
[The killer's name.]

Of course! Writing the killer's name is a sure way to get them caught. You bring your hand onto the wood and realize that you never learned the name of the cabby. Not knowing what to write, you desperately try to think of something else, but your final breaths are spent in frustration, and nothing is written down.

* * *

>x ring
Your wedding ring, though it doesn't mean much these days. You take it off enough that the inside looks almost polished. The inside of the ring is engraved with your and your husband's name.

>x self
As good-looking as ever.

>w
You have no where to go. Better wait here until your cab arrives.

>z
Time passes.

You look out the window of the bar and see a taxi pull up. Better not keep the cabby waiting.

>z
Time passes.

>s
Cab
A small cab, probably a couple decades old. The leather seats have peeled and been rubbed away, but they're more comfortable that way. The dashboard is mostly bare, except for a photo taped to the dash and a rosary hanging from the miror. You can see the back of the cabby's head through the glass, and his eyes through the rear mirror. There is a seat pocket in front of you.

You can see a photo, a rosary, a seat pocket (empty) and a cabby here.

You walk out of the bar and enter the cab. The driver doesn't turn around, but simply asks "Where to?" You give him your home address and sit back.

>z
Time passes.

>z
Time passes.

Its probably going to be a long cab ride.

>z
Time passes.

>z
Time passes.

The cabbies usually don't take this road. Oh well, maybe there was traffic on the way here.

>z
Time passes.

>z
Time passes.

You're going completely the wrong way. You try to tell the cabby, but he doesn't say a word.

>z
Time passes.

I beg your pardon?

I beg your pardon?

>z
Time passes.

* * *

>z
Time passes.

The cabby drives out to a street with a few abandoned buildings and pulls over. Think, Beth, think! You can't get out of the cab, your phone has no signal, is there anything that you can do?

>z
Time passes.

The cabby silently opens his side of the door, closes it, and opens the door on your side. You turn and kick him in the groin as soon as he opens the door. He doubles over for a moment, but recovers before you can strike again. 

 "Alright, we're going to have a little chat, you and I. But first..." 

 With speed that you did not expect, the cabby pulls out a syringe and jabs you in the neck with it. It only takes a few seconds before your vision goes dark.

abandoned apartment
A musty old room that you assume once was a living area of someone's flat, but it has been abandoned for so long that the wood has rotted, and time has put holes in the roof. The state of the room, however is the least of your concerns. There is a murderer right in front of you.

The cabby sits in front of you. He seems eerily calm about the whole situation. 
 "Wake up, sleepyhead. I told ya that we was gonna have a little chat, so here we are. Don't worry, I didn't do nothing else to ya, sides the sleepin medicine. Now, you're Beth, yeah? Don't matter. After all, you're gonna be dead in a few minutes." 

 You ask if he is going to kill you here, and he chuckles. 

 "Naw, I'm just gonna talk to ya, and then you're gonna kill yourself."

>z
Time passes.

>z
Time passes.

The cabby seems to grow impatient. 
 "Now we're gonna play a little game, just the two of us. Look here, I got two bottles, each with a pill inside, identical in every way, cept one. One of the pills is harmless, and the other's got poison in it. I'm gonna put these bottles down, and you're gonna pick one, and take the pill inside, and I'll take the other, winner walks away alive." 

 He places the two identical bottles down onto the floor, and slides one toward you. 

 "Now, did I just give you the good bottle, or the bad bottle? I can tell you right now I'm gonna win, cause I know how people think. Now, make your move.

>take close bottle
You pick up the bottle closer to you, open it, and take the pill inside. At the same time, the cabby takes the other bottle and takes that pill. A few moments pass, and the cabby begins to laugh hysterically. You double over in pain, and the cabby stands up and starts to leave the room. 

 "I told ya, I always win. Sorry, love, but it won't be long now. But hey, thanks for making the cleanup so easy on me." 

 Your vision blurs as you collapse to the ground. You realize that these are probably your last moments. Your thoughts race, and you try to think of something, anything you can do. You see your hands on the floor, your nails are pretty sharp. You could probably carve something into the soft wooden floor. Maybe you can stop this sick bastard after all.

abandoned apartment
An old, run-down flat a few miles outside of London. Most of the wood is rotting or damp, or both. However, you did not come here to criticize the shortcomings of homeowners, you have a murder to solve.

You can see a far bottle, a close bottle, a cabby and Beth here.

What will you carve into the ground?

1) The killer's name.
2) Your daughter's name.
3) Your husband's name.

>2
[Your daughter's name.]

In your last moments, your thoughts drift to your daughter. She never made it past the age of two, that's when the cancer got her. You painstakingly carve in "RACHEL" into the ground, and as your final breath leaves your lungs, you hope that you will see her soon.

abandoned apartment
An old, run-down flat a few miles outside of London. Most of the wood is rotting or damp, or both. However, you did not come here to criticize the shortcomings of homeowners, you have a murder to solve.

>look
abandoned apartment
An old, run-down flat a few miles outside of London. Most of the wood is rotting or damp, or both. However, you did not come here to criticize the shortcomings of homeowners, you have a murder to solve.

>i
You are carrying nothing.

>take matchbook
You can't see any such thing.

* * *

>take matchbook
Taken.

>zyzzy
I didn't understand that sentence.

>xyzzy
I didn't understand that sentence.

>wait
Time passes.

>z
Time passes.

You look out the window of the bar and see a taxi pull up. Better not keep the cabby waiting.

>s
Cab
A small cab, probably a couple decades old. The leather seats have peeled and been rubbed away, but they're more comfortable that way. The dashboard is mostly bare, except for a photo taped to the dash and a rosary hanging from the miror. You can see the back of the cabby's head through the glass, and his eyes through the rear mirror. There is a seat pocket in front of you.

You can see a photo, a rosary, a seat pocket (empty) and a cabby here.

You walk out of the bar and enter the cab. The driver doesn't turn around, but simply asks "Where to?" You give him your home address and sit back.

>z 10
I only understood you as far as wanting to wait.

>wait 10
I only understood you as far as wanting to wait.

>z
Time passes.

* * *

>take far bottle
You pick up the bottle farther away from you, open it, and take the pill inside. At the same time, the cabby takes the other bottle and takes that pill. A few moments pass, and the cabby begins to laugh hysterically. You double over in pain, and the cabby stands up and starts to leave the room. 

 "I told ya, I always win. Sorry, love, but it won't be long now. But hey, thanks for making the cleanup so easy on me." 

 Your vision blurs as you collapse to the ground. You realize that these are probably your last moments. Your thoughts race, and you try to think of something, anything you can do. You see your hands on the floor, your nails are pretty sharp. You could probably carve something into the soft wooden floor. Maybe you can stop this sick bastard after all.

abandoned apartment
An old, run-down flat a few miles outside of London. Most of the wood is rotting or damp, or both. However, you did not come here to criticize the shortcomings of homeowners, you have a murder to solve.

You can see a far bottle, a close bottle, a cabby and Beth here.

What will you carve into the ground?

1) The killer's name.
2) Your daughter's name.
3) Your husband's name.

>2
[Your daughter's name.]

In your last moments, your thoughts drift to your daughter. She never made it past the age of two, that's when the cancer got her. You painstakingly carve in "RACHEL" into the ground, and as your final breath leaves your lungs, you hope that you will see her soon.

abandoned apartment
An old, run-down flat a few miles outside of London. Most of the wood is rotting or damp, or both. However, you did not come here to criticize the shortcomings of homeowners, you have a murder to solve.

You can see a matchbook here.

>i
You are carrying nothing.

>x self
You are Sherlock Holmes. Often times when a case looks particularly difficult, or when the local police force can't be bothered to do their jobs correctly, they call you in to provide some insight. While most of their "cases" rarely merit a second thought, this one intrigues you. A suicide, but so obviously not so, perplexing. You arrived onto the scene mere hours after the police discovered the body, and you get to begin the investigation before the Medical Examiner even arrived. One of the perks of having the chief detective inspector owe you a favor. Now it is just you and the murder. The game is afoot.

>x matchbook
A tiny book of matches with the hotel's name on the front, "The Easton." Used for advertising. You might want to go out for a smoke later.

>s
Surprisingly, the cabby lets you stand up and go try the exit. Naturally it's locked tight, and all the windows are boarded up.

* * *

>take matchbook
Taken.

>z
Time passes.

>z
Time passes.

You look out the window of the bar and see a taxi pull up. Better not keep the cabby waiting.

I beg your pardon?

>s
Cab
A small cab, probably a couple decades old. The leather seats have peeled and been rubbed away, but they're more comfortable that way. The dashboard is mostly bare, except for a photo taped to the dash and a rosary hanging from the miror. You can see the back of the cabby's head through the glass, and his eyes through the rear mirror. There is a seat pocket in front of you.

You can see a photo, a rosary, a seat pocket (empty) and a cabby here.

You walk out of the bar and enter the cab. The driver doesn't turn around, but simply asks "Where to?" You give him your home address and sit back.

* * *

>z
Time passes.

The cabby drives out to a street with a few abandoned buildings and pulls over. Think, Beth, think! You can't get out of the cab, your phone has no signal, is there anything that you can do?

>undo
Cab
[Previous turn undone.]

>put wedding ring in pocket
You put the wedding ring into the seat pocket.

The cabby drives out to a street with a few abandoned buildings and pulls over. Think, Beth, think! You can't get out of the cab, your phone has no signal, is there anything that you can do?

>put cell phone in pocket
You put the cell phone into the seat pocket.

The cabby silently opens his side of the door, closes it, and opens the door on your side. You turn and kick him in the groin as soon as he opens the door. He doubles over for a moment, but recovers before you can strike again. 

 "Alright, we're going to have a little chat, you and I. But first..." 

 With speed that you did not expect, the cabby pulls out a syringe and jabs you in the neck with it. It only takes a few seconds before your vision goes dark.

abandoned apartment
A musty old room that you assume once was a living area of someone's flat, but it has been abandoned for so long that the wood has rotted, and time has put holes in the roof. The state of the room, however is the least of your concerns. There is a murderer right in front of you.

The cabby sits in front of you. He seems eerily calm about the whole situation. 
 "Wake up, sleepyhead. I told ya that we was gonna have a little chat, so here we are. Don't worry, I didn't do nothing else to ya, sides the sleepin medicine. Now, you're Beth, yeah? Don't matter. After all, you're gonna be dead in a few minutes." 

 You ask if he is going to kill you here, and he chuckles. 

 "Naw, I'm just gonna talk to ya, and then you're gonna kill yourself."

>spit in his face
I didn't understand that sentence.

>i
You are carrying:
  a matchbook

>use matchbook
Fire is not the solution here.

The cabby seems to grow impatient. 
 "Now we're gonna play a little game, just the two of us. Look here, I got two bottles, each with a pill inside, identical in every way, cept one. One of the pills is harmless, and the other's got poison in it. I'm gonna put these bottles down, and you're gonna pick one, and take the pill inside, and I'll take the other, winner walks away alive." 

 He places the two identical bottles down onto the floor, and slides one toward you. 

 "Now, did I just give you the good bottle, or the bad bottle? I can tell you right now I'm gonna win, cause I know how people think. Now, make your move.

>do not take bottle
I didn't understand that sentence.

>take bottle
Which do you mean, the far bottle or the close bottle?

>close
(the matchbook)
It isn't something you can close.

>close bottle
Which do you mean, the far bottle or the close bottle?

>close bottle
Which do you mean, the far bottle or the close bottle?

>second one
You can't see any such thing.

>the close bottle
I didn't understand that sentence.

>take the close bottle
You pick up the bottle closer to you, open it, and take the pill inside. At the same time, the cabby takes the other bottle and takes that pill. A few moments pass, and the cabby begins to laugh hysterically. You double over in pain, and the cabby stands up and starts to leave the room. 

 "I told ya, I always win. Sorry, love, but it won't be long now. But hey, thanks for making the cleanup so easy on me." 

 Your vision blurs as you collapse to the ground. You realize that these are probably your last moments. Your thoughts race, and you try to think of something, anything you can do. You see your hands on the floor, your nails are pretty sharp. You could probably carve something into the soft wooden floor. Maybe you can stop this sick bastard after all.

What will you carve into the ground?

1) The killer's name.
2) Your daughter's name.
3) Your husband's name.

>1
[The killer's name.]

Of course! Writing the killer's name is a sure way to get them caught. You bring your hand onto the wood and realize that you never learned the name of the cabby. Not knowing what to write, you desperately try to think of something else, but your final breaths are spent in frustration, and nothing is written down.

Of course! Writing the killer's name is a sure way to get them caught. You bring your hand onto the wood and realize that you never learned the name of the cabby. Not knowing what to write, you desperately try to think of something else, but your final breaths are spent in frustration, and nothing is written down.

abandoned apartment
An old, run-down flat a few miles outside of London. Most of the wood is rotting or damp, or both. However, you did not come here to criticize the shortcomings of homeowners, you have a murder to solve.

You can see a corpse and a matchbook here.

>examine corpse
It appears that this poor lady met an unfortunate fate tonight. Worse news, the police haven't even had time to identify the body yet, so It's up to you to figure this out quickly. The killer seems to have taken anything off of the body that he deemed valuable or important. They are likely looking for an escape, and you ought to find them before they get away. 
One interesting thing you find, however is that her fingers look ragged, and there are some scratches on the floor next to her hand.

There are some scrawlings on the ground, some look like letters, but others seem purely illegible. Either way, you can't make out what it is supposed to say.

>welp
I didn't understand that sentence.

>read letters
You can't see any such thing.

>look ariund
You can't see any such thing.

>look around
You can't see any such thing.

>look at body
You can't see any such thing.

>i
You are carrying nothing.

>kill myself
Violence isn't the answer to this one.

>check pulse
You can't see any such thing.

>look at nails
You can't see any such thing.

>stop
I didn't understand that sentence.

>wy
I didn't understand that sentence.

>find door
I didn't understand that sentence.

>check corpse
It appears that this poor lady met an unfortunate fate tonight. Worse news, the police haven't even had time to identify the body yet, so It's up to you to figure this out quickly. The killer seems to have taken anything off of the body that he deemed valuable or important. They are likely looking for an escape, and you ought to find them before they get away. 
One interesting thing you find, however is that her fingers look ragged, and there are some scratches on the floor next to her hand.

There are some scrawlings on the ground, some look like letters, but others seem purely illegible. Either way, you can't make out what it is supposed to say.

>check pockets
You can't see any such thing.

>check corpses' pockets
You can't see any such thing.

>x matchbook
A small book of matches, unused. There is a hotel's name on the side: the Easton.

It's not much, but it's a lead. You might as well go and check out the hotel bar and see if you can figure out who this woman was. 

 HINT: Use "go to" to move from place to place as Sherlock

>i
You are carrying nothing.

>look
abandoned apartment
An old, run-down flat a few miles outside of London. Most of the wood is rotting or damp, or both. However, you did not come here to criticize the shortcomings of homeowners, you have a murder to solve.

You can see a corpse and a matchbook here.

>take matchbook
Taken.

>x cell phone
You can't see any such thing.

* * *

>wshy not
I didn't understand that sentence.

>x self
You are Sherlock Holmes. Often times when a case looks particularly difficult, or when the local police force can't be bothered to do their jobs correctly, they call you in to provide some insight. While most of their "cases" rarely merit a second thought, this one intrigues you. A suicide, but so obviously not so, perplexing. You arrived onto the scene mere hours after the police discovered the body, and you get to begin the investigation before the Medical Examiner even arrived. One of the perks of having the chief detective inspector owe you a favor. Now it is just you and the murder. The game is afoot.

>x matchbook
A small book of matches, unused. There is a hotel's name on the side: the Easton.

It's not much, but it's a lead. You might as well go and check out the hotel bar and see if you can figure out who this woman was. 

 HINT: Use "go to" to move from place to place as Sherlock

* * *

I beg your pardon?

* * *

>z
Time passes.

>drop phone
Dropped.

The cabbies usually don't take this road. Oh well, maybe there was traffic on the way here.

>z
Time passes.

* * *

>take close bottle
You pick up the bottle closer to you, open it, and take the pill inside. At the same time, the cabby takes the other bottle and takes that pill. A few moments pass, and the cabby begins to laugh hysterically. You double over in pain, and the cabby stands up and starts to leave the room. 

 "I told ya, I always win. Sorry, love, but it won't be long now. But hey, thanks for making the cleanup so easy on me." 

 Your vision blurs as you collapse to the ground. You realize that these are probably your last moments. Your thoughts race, and you try to think of something, anything you can do. You see your hands on the floor, your nails are pretty sharp. You could probably carve something into the soft wooden floor. Maybe you can stop this sick bastard after all.

What will you carve into the ground?

1) The killer's name.
2) Your daughter's name.
3) Your husband's name.

>2
[Your daughter's name.]

In your last moments, your thoughts drift to your daughter. She never made it past the age of two, that's when the cancer got her. You painstakingly carve in "RACHEL" into the ground, and as your final breath leaves your lungs, you hope that you will see her soon.

In your last moments, your thoughts drift to your daughter. She never made it past the age of two, that's when the cancer got her. You painstakingly carve in "RACHEL" into the ground, and as your final breath leaves your lungs, you hope that you will see her soon.

abandoned apartment
An old, run-down flat a few miles outside of London. Most of the wood is rotting or damp, or both. However, you did not come here to criticize the shortcomings of homeowners, you have a murder to solve.

You can see a corpse and a matchbook here.

>x matchbook
A small book of matches, unused. There is a hotel's name on the side: the Easton.

It's not much, but it's a lead. You might as well go and check out the hotel bar and see if you can figure out who this woman was. 

 HINT: Use "go to" to move from place to place as Sherlock

>go to hotel bar
Hotel Bar
The hotel bar of some high-class hotel on the south side of London: The Easton. Given that it's still the middle of the night, no one else is here, save for the bartender.

You can see a decorative bowl (empty) and a bartender here.

>z
Time passes.

>z
Time passes.

    *** The matchbook was a promising lead, but it seems to be a dead end. After fumbling around the hotel bar for a while, you realize that there is no more information to be found here. If only there was a way to find her name. And without any more leads to follow, you return to the detective inspector with your bad news. The killer is likely to get away by morning.

 Try again! There must be some way to learn the victim's name... ***

Would you like to RESTART, RESTORE a saved game, QUIT or UNDO the last command?

>restart
WARNING: This game is going to be difficult, and will likely require multiple playthroughs in order to reach a successful outcome, unless you are incredibly clever. You must learn from your mistakes in the past to secure the future. The game is afoot! 

You are Beth Davenport, an official at the Ministry of Transport, but that is not the important part of the story. You are out at a hotel on the south side of London, hoping to find a weary businessman to make the night less lonely, but your husband doesn't know that. You have been sitting at the bar for a few hours now, and with no prospects in sight, you are feeling that you might just be better off going home. You called a cab a few minutes ago, and it should be getting here in a few minutes.

The Pink Pill
An Interactive Fiction by Ryan
Release 1 / Serial number 180426 / Inform 7 build 6M62 (I6/v6.33 lib 6/12N) SD

Hotel Bar
The hotel bar on the first floor of some gaudy hotel that you have forgotten the name of. It's not important anyways. After all, you're not going to be paying for a room tonight. At least, that was your plan. Not many people here tonight, just the bartender and some lonely chairs. The exit is to the south.

You can see a cocktail, a decorative bowl (in which is a matchbook) and a bartender here.

>drop ring
Dropped.

>z
Time passes.

>drop phone
Dropped.

Its probably going to be a long cab ride.

>z
Time passes.

* * *

I beg your pardon?

>z
Time passes.

You are starting to get very worried, the last street you recognized was three turns ago. You check your phone: no signal.

* * *

>2
[Your daughter's name.]

In your last moments, your thoughts drift to your daughter. She never made it past the age of two, that's when the cancer got her. You painstakingly carve in "RACHEL" into the ground, and as your final breath leaves your lungs, you hope that you will see her soon.

In your last moments, your thoughts drift to your daughter. She never made it past the age of two, that's when the cancer got her. You painstakingly carve in "RACHEL" into the ground, and as your final breath leaves your lungs, you hope that you will see her soon.

abandoned apartment
An old, run-down flat a few miles outside of London. Most of the wood is rotting or damp, or both. However, you did not come here to criticize the shortcomings of homeowners, you have a murder to solve.

You can see a corpse here.

>restart
Are you sure you want to restart?

>y
WARNING: This game is going to be difficult, and will likely require multiple playthroughs in order to reach a successful outcome, unless you are incredibly clever. You must learn from your mistakes in the past to secure the future. The game is afoot! 

You are Beth Davenport, an official at the Ministry of Transport, but that is not the important part of the story. You are out at a hotel on the south side of London, hoping to find a weary businessman to make the night less lonely, but your husband doesn't know that. You have been sitting at the bar for a few hours now, and with no prospects in sight, you are feeling that you might just be better off going home. You called a cab a few minutes ago, and it should be getting here in a few minutes.

The Pink Pill
An Interactive Fiction by Ryan
Release 1 / Serial number 180426 / Inform 7 build 6M62 (I6/v6.33 lib 6/12N) SD

Hotel Bar
The hotel bar on the first floor of some gaudy hotel that you have forgotten the name of. It's not important anyways. After all, you're not going to be paying for a room tonight. At least, that was your plan. Not many people here tonight, just the bartender and some lonely chairs. The exit is to the south.

You can see a cocktail, a decorative bowl (in which is a matchbook) and a bartender here.

>take matchbook
Taken.

>drop ring
Dropped.

* * *

>z
Time passes.

>z
Time passes.

The cabby honks outside, He's getting impatient.

>z
Time passes.

>z
Time passes.

The cabby lays on the horn, most drivers would have driven off by now, how kind that he waited for you to putz about the bar.

>z
Time passes.

* * *

>x matchbook
A small book of matches, unused. There is a hotel's name on the side: the Easton.

It's not much, but it's a lead. You might as well go and check out the hotel bar and see if you can figure out who this woman was. 

 HINT: Use "go to" to move from place to place as Sherlock

>take matchbook
Taken.

>go to hotel bar
Hotel Bar
The hotel bar of some high-class hotel on the south side of London: The Easton. Given that it's still the middle of the night, no one else is here, save for the bartender.

You can see a wedding ring, a decorative bowl (empty) and a bartender here.

>x ring
A simple wedding ring with a diamond embedded into it. upon closer inspection, you see that there are two names engraved on the inside of it.

This wedding ring likely belonged to the victim. Her name was Beth. She was clever, leaving the wedding ring here, where she knew that it wouldn't be discarded, and who would steal an engraved wedding ring? Perhaps the bartender can give you some more information now that you have a couple of names.

>talk to bartender
You approach the bartender and tell him about the murder case. You show him the ring. He squints at it as he attempts to read the names engraved on the inside. You ask him if he knows anything about the names. 
"Beth... yeah, yeah I know Beth! She's come in here a few times before, always leaves with a different guy. You say she's dead? Oh no... She bought a drink earlier, so I should be able to pull up the credit card, maybe get you an address. 
 The bartender runs off behind the bar, messes with the computer for a few mintues, and comes back with a piece of paper with an address on it. You commit the address to memory. 

 You now have access to Beth's house

>go to beth's house
Beth's house
A quaint home a few miles outside of the city. There isn't much in the ways of interior decorating, but that's not important right now. The most notable room in the house is the office, where the man who let you in is sitting in the chair.

You can see a husband and a computer here.

After the man introduced himself as Beth's husband, Thomas, you caught him up on the current situation. He immediately broke down into a sobbing mess. Understandable, but not helpful at the moment. He lets you in anyways, hopeful that you can find the person that did this to Beth. You've come this far, surely there must be some sign of where she went in her own house! You walk into the office, as that seems to be the best place to find information at the moment.

>talk to husband
You ask him several questions about Beth, her job, her life, and what she was doing tonight, but he is generally unhelpful. However, you do figure out one interesting piece of information. She uses her phone for nearly everything, and as a result, she loses it quite frequently. To solve this problem, she tracks her phone using her home computer. The only problem is that Thomas does not know Beth's phone password, and it is required to track the phone.

>use computer
*** You sit down at the computer and open the program to track the phone. Every piece of evidence left behind so far has had a purpose, except one: the carving on the ground. Suddenly, you understand. She is brilliant!, you think, she's more brilliant than anyone in London and she's dead! You type in "RACHEL" into the computer, and you log in. The map opens and shows the last location the phone was used was... 
 The London Docks? Last updated three minutes ago! 
 Of course! She left her phone in the cab so that it could be tracked wherever the killer went! They must have gone to the docks to get out of the city without being followed, but little do they know, Beth was leading you right to them. 

You burst out of the house and call the detective inspector, and tell him to meet you at the docks. You arrive just behind a half dozen police cars. Given that it is the middle of the night, the only other car you see is a london taxi. The officers leap out of their cars and sweep the area. It isn't three minutes before the suspect is found. You see him screaming about his perfect plan as he is dragged away, and know that you found the right man. If not for Beth's foresight, he might have gotten away, but at last, justice has been served. 

 Congratulaions, YOU WIN! Your cleverness and insight are truly magnificent, well done! ***

Would you like to RESTART, RESTORE a saved game, QUIT or UNDO the last command?

* * *

>x matchbook
A tiny book of matches with the hotel's name on the front, "The Easton." Used for advertising. You might want to go out for a smoke later.

>take matchbook
Taken.

>restart
Are you sure you want to restart?

>y
WARNING: This game is going to be difficult, and will likely require multiple playthroughs in order to reach a successful outcome, unless you are incredibly clever. You must learn from your mistakes in the past to secure the future. The game is afoot! 

You are Beth Davenport, an official at the Ministry of Transport, but that is not the important part of the story. You are out at a hotel on the south side of London, hoping to find a weary businessman to make the night less lonely, but your husband doesn't know that. You have been sitting at the bar for a few hours now, and with no prospects in sight, you are feeling that you might just be better off going home. You called a cab a few minutes ago, and it should be getting here in a few minutes.

The Pink Pill
An Interactive Fiction by Ryan
Release 1 / Serial number 180425 / Inform 7 build 6M62 (I6/v6.33 lib 6/12N) SD

Hotel Bar
The hotel bar on the first floor of some gaudy hotel that you have forgotten the name of. It's not important anyways. After all, you're not going to be paying for a room tonight. At least, that was your plan. Not many people here tonight, just the bartender and some lonely chairs. The exit is to the south.

You can see a cocktail, a decorative bowl (in which is a matchbook) and a bartender here.

>go to caby
That noun did not make sense in this context.

>go to cab
You have no way to get there at the moment.

>restart
Are you sure you want to restart?

* * *

>x chairs
You can't see any such thing.

>x bartender
The bartender stands down the bar. He looks like he's cleaning up for the night, you're one of the last people here. You thought about chatting him up, but he's not really your type, and you're pretty sure he remembers you from the last time you were here.

>talk to bartender
You consider chatting up the bartender, but it's late, and you've essentially given up on your little escapade for tonight.

>s
You have no where to go. Better wait here until your cab arrives.

>z
Time passes.

You look out the window of the bar and see a taxi pull up. Better not keep the cabby waiting.

>x taxi
You can't see any such thing.

>enter taxi
You can't see any such thing.

>z
Time passes.

>go to taxi
That noun did not make sense in this context.

>walk to taxi
That noun did not make sense in this context.

>enter taxi
You can't see any such thing.

>get in taxi
You can't see any such thing.

>talk to taxi
You can't see any such thing.

>s
Cab
A small cab, probably a couple decades old. The leather seats have peeled and been rubbed away, but they're more comfortable that way. The dashboard is mostly bare, except for a photo taped to the dash and a rosary hanging from the miror. You can see the back of the cabby's head through the glass, and his eyes through the rear mirror. There is a seat pocket in front of you.

You can see a photo, a rosary, a seat pocket (empty) and a cabby here.

You walk out of the bar and enter the cab. The driver doesn't turn around, but simply asks "Where to?" You give him your home address and sit back.

>x cabby
From the little you've seen of the cabby, he looks pretty old. He's got gray hair and a wool cap. You can see wrinkles on his face through the rear mirror.

>x photo
An old polaroid picturing three people: a woman and two children. You imagine that this must be the cabby's family.

Its probably going to be a long cab ride.

>x rosary
A rosary, looks old.

>take all
photo: The pane of plexiglass separates you from the front half of the cab.
rosary: The pane of plexiglass separates you from the front half of the cab.
cabby: Even if you could, the glass is in the way.

The cabbies usually don't take this road. Oh well, maybe there was traffic on the way here.

>x seat pocket
A leather seat pocket attached to the seat in front of you.

>search seat pocket
The seat pocket is empty.

You're going completely the wrong way. You try to tell the cabby, but he doesn't say a word.

>z
Time passes.

* * *

>z
Time passes.

The cabby drives out to a street with a few abandoned buildings and pulls over. Think, Beth, think! You can't get out of the cab, your phone has no signal, is there anything that you can do?

>attack cabby
Violence isn't the answer to this one.

The cabby silently opens his side of the door, closes it, and opens the door on your side. You turn and kick him in the groin as soon as he opens the door. He doubles over for a moment, but recovers before you can strike again. 

 "Alright, we're going to have a little chat, you and I. But first..." 

 With speed that you did not expect, the cabby pulls out a syringe and jabs you in the neck with it. It only takes a few seconds before your vision goes dark.

abandoned apartment
A musty old room that you assume once was a living area of someone's flat, but it has been abandoned for so long that the wood has rotted, and time has put holes in the roof. The state of the room, however is the least of your concerns. There is a murderer right in front of you.

The cabby sits in front of you. He seems eerily calm about the whole situation. 
 "Wake up, sleepyhead. I told ya that we was gonna have a little chat, so here we are. Don't worry, I didn't do nothing else to ya, sides the sleepin medicine. Now, you're Beth, yeah? Don't matter. After all, you're gonna be dead in a few minutes." 

 You ask if he is going to kill you here, and he chuckles. 

 "Naw, I'm just gonna talk to ya, and then you're gonna kill yourself."

>take all
cabby: Even if you could, the glass is in the way.

>talk to cabby
You question the cabby about his various motives and means of his kidnappings, but he either dodges the question, or just starts laughing.

The cabby seems to grow impatient. 
 "Now we're gonna play a little game, just the two of us. Look here, I got two bottles, each with a pill inside, identical in every way, cept one. One of the pills is harmless, and the other's got poison in it. I'm gonna put these bottles down, and you're gonna pick one, and take the pill inside, and I'll take the other, winner walks away alive." 

 He places the two identical bottles down onto the floor, and slides one toward you. 

 "Now, did I just give you the good bottle, or the bad bottle? I can tell you right now I'm gonna win, cause I know how people think. Now, make your move.

>attack cabby
Violence isn't the answer to this one.

>x good bottle
You can't see any such thing.

>x bottle
Which do you mean, the far bottle or the close bottle?

>far bottle
A small clear bottle with a pink pill inside. It looks identical to its counterpart.

>x close bottle
A small clear bottle with a pink pill inside. It looks identical to its counterpart.

>take far bottle
You pick up the bottle farther away from you, open it, and take the pill inside. At the same time, the cabby takes the other bottle and takes that pill. A few moments pass, and the cabby begins to laugh hysterically. You double over in pain, and the cabby stands up and starts to leave the room. 

 "I told ya, I always win. Sorry, love, but it won't be long now. But hey, thanks for making the cleanup so easy on me." 

 Your vision blurs as you collapse to the ground. You realize that these are probably your last moments. Your thoughts race, and you try to think of something, anything you can do. You see your hands on the floor, your nails are pretty sharp. You could probably carve something into the soft wooden floor. Maybe you can stop this sick bastard after all.

What will you carve into the ground?

1) The killer's name.
2) Your daughter's name.
3) Your husband's name.

>2
[Your daughter's name.]

In your last moments, your thoughts drift to your daughter. She never made it past the age of two, that's when the cancer got her. You painstakingly carve in "RACHEL" into the ground, and as your final breath leaves your lungs, you hope that you will see her soon.

In your last moments, your thoughts drift to your daughter. She never made it past the age of two, that's when the cancer got her. You painstakingly carve in "RACHEL" into the ground, and as your final breath leaves your lungs, you hope that you will see her soon.

abandoned apartment
An old, run-down flat a few miles outside of London. Most of the wood is rotting or damp, or both. However, you did not come here to criticize the shortcomings of homeowners, you have a murder to solve.

You can see a corpse here.

>x corpse
It appears that this poor lady met an unfortunate fate tonight. Worse news, the police haven't even had time to identify the body yet, so It's up to you to figure this out quickly. The killer is likely looking for an escape, and you ought to find them before they get away.

>x room
You can't see any such thing.

>x wood
You can't see any such thing.

>take all
There are none at all available!

>x wod
You can't see any such thing.

>x wood
You can't see any such thing.

>x ground
You can't see any such thing.

>n
Wandering aimlessly won't solve anything.

>s
Wandering aimlessly won't solve anything.

>e
Wandering aimlessly won't solve anything.

>w
Wandering aimlessly won't solve anything.

>look
abandoned apartment
An old, run-down flat a few miles outside of London. Most of the wood is rotting or damp, or both. However, you did not come here to criticize the shortcomings of homeowners, you have a murder to solve.

You can see a corpse here.

>sniff corpse
You smell nothing unexpected.

>search corpse
There is nothing on the corpse.

>i
You are carrying nothing.

>look
abandoned apartment
An old, run-down flat a few miles outside of London. Most of the wood is rotting or damp, or both. However, you did not come here to criticize the shortcomings of homeowners, you have a murder to solve.

You can see a corpse here.

>go to hotel bar
Now why would you go there?

>x self
You are Sherlock Holmes. Often times when a case looks particularly difficult, or when the local police force can't be bothered to do their jobs correctly, they call you in to provide some insight. While most of their "cases" rarely merit a second thought, this one intrigues you. A suicide, but so obviously not so, perplexing. You arrived onto the scene mere hours after the police discovered the body, and you get to begin the investigation before the Medical Examiner even arrived. One of the perks of having the chief detective inspector owe you a favor. Now it is just you and the murder. The game is afoot.

>use corpse
I didn't understand that sentence.

>use
I didn't understand that sentence.

>use door
I didn't understand that sentence.

* * *

>talk to bartender
You consider chatting up the bartender, but it's late, and you've essentially given up on your little escapade for tonight.

>drink cocktail
There's nothing suitable to drink here.

>take matchbook
Taken.

>exit bar
I only understood you as far as wanting to exit.

>exit hotel
I only understood you as far as wanting to exit.

>leave ba
I only understood you as far as wanting to leave.

>stand up
But you aren't in anything at the moment.

You look out the window of the bar and see a taxi pull up. Better not keep the cabby waiting.

>go to taxi
That noun did not make sense in this context.

>go outside
Cab
A small cab, probably a couple decades old. The leather seats have peeled and been rubbed away, but they're more comfortable that way. The dashboard is mostly bare, except for a photo taped to the dash and a rosary hanging from the miror. You can see the back of the cabby's head through the glass, and his eyes through the rear mirror. There is a seat pocket in front of you.

You can see a photo, a rosary, a seat pocket (empty) and a cabby here.

You walk out of the bar and enter the cab. The driver doesn't turn around, but simply asks "Where to?" You give him your home address and sit back.

>exit car
I only understood you as far as wanting to exit.

>open door
You can't see any such thing.

>talk to driver
You can't see any such thing.

>light match
You can't see any such thing.

>take photo
The pane of plexiglass separates you from the front half of the cab.

>examine rosary
A rosary, looks old.

Its probably going to be a long cab ride.

>examine cabby
From the little you've seen of the cabby, he looks pretty old. He's got gray hair and a wool cap. You can see wrinkles on his face through the rear mirror.

>examine photo
An old polaroid picturing three people: a woman and two children. You imagine that this must be the cabby's family.

The cabbies usually don't take this road. Oh well, maybe there was traffic on the way here.

>break glass
You can't see any such thing.

>take rosary
The pane of plexiglass separates you from the front half of the cab.

>examine pocket
A leather seat pocket attached to the seat in front of you.

You're going completely the wrong way. You try to tell the cabby, but he doesn't say a word.

>shit
I didn't understand that sentence.

>use matchbox
You can't see any such thing.

>use matchbook
Fire is not the solution here.

>i
You are carrying:
  a matchbook
  a wedding ring
  a cell phone

>call mom
I didn't understand that sentence.

>call husband
I didn't understand that sentence.

>throw wedding ring
Dropped.

You are starting to get very worried, the last street you recognized was three turns ago. You check your phone: no signal.

>play games
I didn't understand that sentence.

>open door
You can't see any such thing.

>kick glass
I didn't understand that sentence.

>die
I didn't understand that sentence.

>light match
You can't see any such thing.

>pick up wedding ring
Taken.

>kill driver
You can't see any such thing.

>open window
You can't see any such thing.

>scream
I didn't understand that sentence.

>fuck
I didn't understand that sentence.

>call 911
I didn't understand that sentence.

>hope for rescue
I didn't understand that sentence.

>take off clothes
You can't see any such thing.

>seduce driver
I didn't understand that sentence.

>talk to driver
You can't see any such thing.

>talk to cabby
You don't really have much to say...

>fuck cabby
I didn't understand that sentence.

* * *

>take all
cocktail: It would just be rude to take the drink and the glass with you when you leave, and you don't think the bartender will put it into a cup for you.
bartender: Tempting, but he's not really your type.
matchbook: Taken.

>drink cocktail
There's nothing suitable to drink here.

>s
You have no where to go. Better wait here until your cab arrives.

I beg your pardon?

>z
Time passes.

You look out the window of the bar and see a taxi pull up. Better not keep the cabby waiting.

* * *

>z
Time passes.

The cabby honks outside, He's getting impatient.

>s
Cab
A small cab, probably a couple decades old. The leather seats have peeled and been rubbed away, but they're more comfortable that way. The dashboard is mostly bare, except for a photo taped to the dash and a rosary hanging from the miror. You can see the back of the cabby's head through the glass, and his eyes through the rear mirror. There is a seat pocket in front of you.

You can see a photo, a rosary, a seat pocket (empty) and a cabby here.

You walk out of the bar and enter the cab. The driver doesn't turn around, but simply asks "Where to?" You give him your home address and sit back.

* * *

>z
Time passes.

You're going completely the wrong way. You try to tell the cabby, but he doesn't say a word.

>scream
I didn't understand that sentence.

>z
Time passes.

* * *

>z
Time passes.

You are starting to get very worried, the last street you recognized was three turns ago. You check your phone: no signal.

>pray
I didn't understand that sentence.

>z
Time passes.

* * *

>z
Time passes.

The cabby drives out to a street with a few abandoned buildings and pulls over. Think, Beth, think! You can't get out of the cab, your phone has no signal, is there anything that you can do?

>break window
You can't see any such thing.

>use matchbook
Fire is not the solution here.

The cabby silently opens his side of the door, closes it, and opens the door on your side. You turn and kick him in the groin as soon as he opens the door. He doubles over for a moment, but recovers before you can strike again. 

 "Alright, we're going to have a little chat, you and I. But first..." 

 With speed that you did not expect, the cabby pulls out a syringe and jabs you in the neck with it. It only takes a few seconds before your vision goes dark.

abandoned apartment
A musty old room that you assume once was a living area of someone's flat, but it has been abandoned for so long that the wood has rotted, and time has put holes in the roof. The state of the room, however is the least of your concerns. There is a murderer right in front of you.

The cabby sits in front of you. He seems eerily calm about the whole situation. 
 "Wake up, sleepyhead. I told ya that we was gonna have a little chat, so here we are. Don't worry, I didn't do nothing else to ya, sides the sleepin medicine. Now, you're Beth, yeah? Don't matter. After all, you're gonna be dead in a few minutes." 

 You ask if he is going to kill you here, and he chuckles. 

 "Naw, I'm just gonna talk to ya, and then you're gonna kill yourself."

>look
abandoned apartment
A musty old room that you assume once was a living area of someone's flat, but it has been abandoned for so long that the wood has rotted, and time has put holes in the roof. The state of the room, however is the least of your concerns. There is a murderer right in front of you.

You can see a cabby here.

>walk
You'll have to say which compass direction to go in.

The cabby seems to grow impatient. 
 "Now we're gonna play a little game, just the two of us. Look here, I got two bottles, each with a pill inside, identical in every way, cept one. One of the pills is harmless, and the other's got poison in it. I'm gonna put these bottles down, and you're gonna pick one, and take the pill inside, and I'll take the other, winner walks away alive." 

 He places the two identical bottles down onto the floor, and slides one toward you. 

 "Now, did I just give you the good bottle, or the bad bottle? I can tell you right now I'm gonna win, cause I know how people think. Now, make your move.

>x bottles
You can't see any such thing.

>x bottle
Which do you mean, the far bottle or the close bottle?

>x far bottle
A small clear bottle with a pink pill inside. It looks identical to its counterpart.

>x close bottle
A small clear bottle with a pink pill inside. It looks identical to its counterpart.

* * *

>2
[Your daughter's name.]

In your last moments, your thoughts drift to your daughter. She never made it past the age of two, that's when the cancer got her. You painstakingly carve in "RACHEL" into the ground, and as your final breath leaves your lungs, you hope that you will see her soon.

In your last moments, your thoughts drift to your daughter. She never made it past the age of two, that's when the cancer got her. You painstakingly carve in "RACHEL" into the ground, and as your final breath leaves your lungs, you hope that you will see her soon.

abandoned apartment
An old, run-down flat a few miles outside of London. Most of the wood is rotting or damp, or both. However, you did not come here to criticize the shortcomings of homeowners, you have a murder to solve.

You can see a corpse and a matchbook here.

* * *

>x matchbook
A small book of matches, unused. There is a hotel's name on the side: the Easton.

It's not much, but it's a lead. You might as well go and check out the hotel bar and see if you can figure out who this woman was. 

 HINT: Use "go to" to move from place to place as Sherlock

>go to hotel
Hotel Bar
The hotel bar of some high-class hotel on the south side of London: The Easton. Given that it's still the middle of the night, no one else is here, save for the bartender.

You can see a decorative bowl (empty) and a bartender here.

>talk to bartender
You approach the bartender and tell him about the murder case. You ask if he has seen a woman in the bar earlier this evening. 
 "A woman? I see dozens of people, men and women, every single night down here, never the same. I might be able to help you if I had a little more information. Sorry."

>x bowl
A small bowl that probably used to contain a bunch of matchbooks offered complimentary to patrons.

* * *

>x corpse
You can't see any such thing.

>x corpse
You can't see any such thing.

>w
You can't go that way.

>s
You can't go that way.

>e
You can't go that way.

>n
You can't go that way.

>call cab
I didn't understand that sentence.

>z
Time passes.

    *** The matchbook was a promising lead, but it seems to be a dead end. After fumbling around the hotel bar for a while, you realize that there is no more information to be found here. If only there was a way to find her name. And without any more leads to follow, you return to the detective inspector with your bad news. The killer is likely to get away by morning.

 Try again! There must be some way to learn the victim's name... ***

Would you like to RESTART, RESTORE a saved game, QUIT or UNDO the last command?

>restart
WARNING: This game is going to be difficult, and will likely require multiple playthroughs in order to reach a successful outcome, unless you are incredibly clever. You must learn from your mistakes in the past to secure the future. The game is afoot! 

You are Beth Davenport, an official at the Ministry of Transport, but that is not the important part of the story. You are out at a hotel on the south side of London, hoping to find a weary businessman to make the night less lonely, but your husband doesn't know that. You have been sitting at the bar for a few hours now, and with no prospects in sight, you are feeling that you might just be better off going home. You called a cab a few minutes ago, and it should be getting here in a few minutes.

The Pink Pill
An Interactive Fiction by Ryan
Release 1 / Serial number 180427 / Inform 7 build 6M62 (I6/v6.33 lib 6/12N) SD

Hotel Bar
The hotel bar on the first floor of some gaudy hotel that you have forgotten the name of. It's not important anyways. After all, you're not going to be paying for a room tonight. At least, that was your plan. Not many people here tonight, just the bartender and some lonely chairs. The exit is to the south.

You can see a cocktail, a decorative bowl (in which is a matchbook) and a bartender here.

>take matchbook
Taken.

* * *

>z
Time passes.

>s
You have no where to go. Better wait here until your cab arrives.

You look out the window of the bar and see a taxi pull up. Better not keep the cabby waiting.

>z
Time passes.

* * *

I beg your pardon?

* * *

>take all
matchbook: Taken.

>x corpse
It appears that this poor lady met an unfortunate fate tonight. Worse news, the police haven't even had time to identify the body yet, so It's up to you to figure this out quickly. The killer seems to have taken anything off of the body that he deemed valuable or important. They are likely looking for an escape, and you ought to find them before they get away. 
One interesting thing you find, however is that her fingers look ragged, and there are some scratches on the floor next to her hand.

After a good bit of squinting, you see the name "RACHEL" appear carved into the ground. What this means, you are not yet sure, but this could be useful.

>i
You are carrying:
  a matchbook

>x hand
You can't see any such thing.

>x fingers
You can't see any such thing.

>x corpse
It appears that this poor lady met an unfortunate fate tonight. Worse news, the police haven't even had time to identify the body yet, so It's up to you to figure this out quickly. The killer seems to have taken anything off of the body that he deemed valuable or important. They are likely looking for an escape, and you ought to find them before they get away. 
One interesting thing you find, however is that her fingers look ragged, and there are some scratches on the floor next to her hand.

After a good bit of squinting, you see the name "RACHEL" appear carved into the ground. What this means, you are not yet sure, but this could be useful.

>x rachel
You can't see any such thing.

>x room
You can't see any such thing.

>look
abandoned apartment
An old, run-down flat a few miles outside of London. Most of the wood is rotting or damp, or both. However, you did not come here to criticize the shortcomings of homeowners, you have a murder to solve.

You can see a corpse here.

>e
Wandering aimlessly won't solve anything.

* * *

>w
Wandering aimlessly won't solve anything.

>s
Wandering aimlessly won't solve anything.

>n
Wandering aimlessly won't solve anything.

>go to outside
That noun did not make sense in this context.

>go to Watson
That noun did not make sense in this context.

>go to hotel
Now why would you go there?

>x matchbook
A small book of matches, unused. There is a hotel's name on the side: the Easton.

It's not much, but it's a lead. You might as well go and check out the hotel bar and see if you can figure out who this woman was. 

 HINT: Use "go to" to move from place to place as Sherlock

>n
Wandering aimlessly won't solve anything.

>go to hotel
Hotel Bar
The hotel bar of some high-class hotel on the south side of London: The Easton. Given that it's still the middle of the night, no one else is here, save for the bartender.

You can see a decorative bowl (empty) and a bartender here.

>s
You can't go that way.

>talk to bartender
You approach the bartender and tell him about the murder case. You ask if he has seen a woman in the bar earlier this evening. 
 "A woman? I see dozens of people, men and women, every single night down here, never the same. I might be able to help you if I had a little more information. Sorry."

>ask about rachel
You can't see any such thing.

>ask about beth
You can't see any such thing.

>z
Time passes.

>restart
Are you sure you want to restart?

>y
WARNING: This game is going to be difficult, and will likely require multiple playthroughs in order to reach a successful outcome, unless you are incredibly clever. You must learn from your mistakes in the past to secure the future. The game is afoot! 

You are Beth Davenport, an official at the Ministry of Transport, but that is not the important part of the story. You are out at a hotel on the south side of London, hoping to find a weary businessman to make the night less lonely, but your husband doesn't know that. You have been sitting at the bar for a few hours now, and with no prospects in sight, you are feeling that you might just be better off going home. You called a cab a few minutes ago, and it should be getting here in a few minutes.

The Pink Pill
An Interactive Fiction by Ryan
Release 1 / Serial number 180427 / Inform 7 build 6M62 (I6/v6.33 lib 6/12N) SD

Hotel Bar
The hotel bar on the first floor of some gaudy hotel that you have forgotten the name of. It's not important anyways. After all, you're not going to be paying for a room tonight. At least, that was your plan. Not many people here tonight, just the bartender and some lonely chairs. The exit is to the south.

You can see a cocktail, a decorative bowl (in which is a matchbook) and a bartender here.

>i
You are carrying:
  a wedding ring
  a cell phone

>leave cell phone
I only understood you as far as wanting to leave.

>drop all
wedding ring: Dropped.
cell phone: Dropped.

>s
You have no where to go. Better wait here until your cab arrives.

* * *

>z
Time passes.

Its probably going to be a long cab ride.

>restart
Are you sure you want to restart?

* * *

>drop all
wedding ring: Dropped.
cell phone: Dropped.

>tak matchbook
I didn't understand that sentence.

>take matchbook
Taken.

* * *

>s
You have no where to go. Better wait here until your cab arrives.

>s
You have no where to go. Better wait here until your cab arrives.

You look out the window of the bar and see a taxi pull up. Better not keep the cabby waiting.

>s
Cab
A small cab, probably a couple decades old. The leather seats have peeled and been rubbed away, but they're more comfortable that way. The dashboard is mostly bare, except for a photo taped to the dash and a rosary hanging from the miror. You can see the back of the cabby's head through the glass, and his eyes through the rear mirror. There is a seat pocket in front of you.

You can see a photo, a rosary, a seat pocket (empty) and a cabby here.

You walk out of the bar and enter the cab. The driver doesn't turn around, but simply asks "Where to?" You give him your home address and sit back.

* * *

>take both
far bottle: You pick up the bottle farther away from you, open it, and take the pill inside. At the same time, the cabby takes the other bottle and takes that pill. A few moments pass, and the cabby begins to laugh hysterically. You double over in pain, and the cabby stands up and starts to leave the room. 

 "I told ya, I always win. Sorry, love, but it won't be long now. But hey, thanks for making the cleanup so easy on me." 

 Your vision blurs as you collapse to the ground. You realize that these are probably your last moments. Your thoughts race, and you try to think of something, anything you can do. You see your hands on the floor, your nails are pretty sharp. You could probably carve something into the soft wooden floor. Maybe you can stop this sick bastard after all.

What will you carve into the ground?

1) The killer's name.
2) Your daughter's name.
3) Your husband's name.

close bottle: You can't reach into the void.
cabby: You can't reach into the void.

>3
[Your husband's name.]

That's it! If you write your husband's name down, the police will know who to talk to. He can point them in the right direction for sure. You painstakingly carve in "THOMAS" into the ground, and as your final breath leaves your lungs, you pray that what you did was enough.

That's it! If you write your husband's name down, the police will know who to talk to. He can point them in the right direction for sure. You painstakingly carve in "THOMAS" into the ground, and as your final breath leaves your lungs, you pray that what you did was enough.

abandoned apartment
An old, run-down flat a few miles outside of London. Most of the wood is rotting or damp, or both. However, you did not come here to criticize the shortcomings of homeowners, you have a murder to solve.

You can see a corpse and a matchbook here.

>take all
matchbook: Taken.

>x corpse
It appears that this poor lady met an unfortunate fate tonight. Worse news, the police haven't even had time to identify the body yet, so It's up to you to figure this out quickly. The killer seems to have taken anything off of the body that he deemed valuable or important. They are likely looking for an escape, and you ought to find them before they get away. 
One interesting thing you find, however is that her fingers look ragged, and there are some scratches on the floor next to her hand.

There are some scrawlings on the ground, some look like letters, but others seem purely illegible. Either way, you can't make out what it is supposed to say.

>x matchbook
A small book of matches, unused. There is a hotel's name on the side: the Easton.

It's not much, but it's a lead. You might as well go and check out the hotel bar and see if you can figure out who this woman was. 

 HINT: Use "go to" to move from place to place as Sherlock

>go to hotel
Hotel Bar
The hotel bar of some high-class hotel on the south side of London: The Easton. Given that it's still the middle of the night, no one else is here, save for the bartender.

You can see a wedding ring, a decorative bowl (empty) and a bartender here.

>take all
wedding ring: Taken.
bartender: He would only drag you down.

>x ring
A simple wedding ring with a diamond embedded into it. upon closer inspection, you see that there are two names engraved on the inside of it.

This wedding ring likely belonged to the victim. Her name was Beth. She was clever, leaving the wedding ring here, where she knew that it wouldn't be discarded, and who would steal an engraved wedding ring? Perhaps the bartender can give you some more information now that you have a couple of names.

* * *

>go to beths house
That noun did not make sense in this context.

>go to beth's house
Beth's house
A quaint home a few miles outside of the city. There isn't much in the ways of interior decorating, but that's not important right now. The most notable room in the house is the office, where the man who let you in is sitting in the chair.

You can see a husband and a computer here.

After the man introduced himself as Beth's husband, Thomas, you caught him up on the current situation. He immediately broke down into a sobbing mess. Understandable, but not helpful at the moment. He lets you in anyways, hopeful that you can find the person that did this to Beth. You've come this far, surely there must be some sign of where she went in her own house! You walk into the office, as that seems to be the best place to find information at the moment.

>take all
There are none at all available!

>x computer
A fairly new computer lies on the desk, which is rather out of place given that the rest of the office interior seems years old. This must mean that whomever uses this office must use and upgrade the computer on the regular.

>x husband
Beth's husband sits in the office chair in utter shock. A natural response to someone experiencing emotional trauma. You don't expect him to be particularly helpful, but maybe he can shed some light on the situation.

>ask about beth
You can't see any such thing.

>talk to husband
You ask him several questions about Beth, her job, her life, and what she was doing tonight, but he is generally unhelpful. However, you do figure out one interesting piece of information. She uses her phone for nearly everything, and as a result, she loses it quite frequently. To solve this problem, she tracks her phone using her home computer. The only problem is that Thomas does not know Beth's phone password, and it is required to track the phone.

>use password
You can't see any such thing.

>z
Time passes.

>go tovoid
You can't see any such thing.

* * *

>raahel
I didn't understand that sentence.

>rachel
I didn't understand that sentence.

>use rachel
You can't see any such thing.

>use computer
*** You sit down at the computer and open the program to track the phone. You try dozens of words: "Beth", "Easton", "Thomas", "London", nothing. Her password could be anything, and you have no way to know what it is. Every piece of evidence so far led you right here, there must be something missing. You try for hours to find the password, but nothing works. Eventually you go back to the detective inspector, hoping that the police force might be able to do something, but the killer is probably long gone by now. 
 There must be some way to learn the password, Try again! ***

Would you like to RESTART, RESTORE a saved game, QUIT or UNDO the last command?

>restart
WARNING: This game is going to be difficult, and will likely require multiple playthroughs in order to reach a successful outcome, unless you are incredibly clever. You must learn from your mistakes in the past to secure the future. The game is afoot! 

You are Beth Davenport, an official at the Ministry of Transport, but that is not the important part of the story. You are out at a hotel on the south side of London, hoping to find a weary businessman to make the night less lonely, but your husband doesn't know that. You have been sitting at the bar for a few hours now, and with no prospects in sight, you are feeling that you might just be better off going home. You called a cab a few minutes ago, and it should be getting here in a few minutes.

The Pink Pill
An Interactive Fiction by Ryan
Release 1 / Serial number 180427 / Inform 7 build 6M62 (I6/v6.33 lib 6/12N) SD

Hotel Bar
The hotel bar on the first floor of some gaudy hotel that you have forgotten the name of. It's not important anyways. After all, you're not going to be paying for a room tonight. At least, that was your plan. Not many people here tonight, just the bartender and some lonely chairs. The exit is to the south.

You can see a cocktail, a decorative bowl (in which is a matchbook) and a bartender here.

>exit bar
I only understood you as far as wanting to exit.

>leave bar
I only understood you as far as wanting to leave.

>exit
But you aren't in anything at the moment.

>leave
But you aren't in anything at the moment.

>hit bartender
Violence isn't the answer to this one.

>attack bartender
Violence isn't the answer to this one.

You look out the window of the bar and see a taxi pull up. Better not keep the cabby waiting.

* * *

>x self
As good-looking as ever.

>x Beth
You can't see any such thing.

* * *

>x television
The television behind the bar is currently showing an episode of one of those crime dramas where the woman gets kidnapped and killed after being utterly useless. Then the detective comes in and magically already knows all of the information about the case, and perfectly catches the killer on the first try. Never was your kind of show.

>drink cocktail
There's nothing suitable to drink here.

>drop ring
Dropped.

>x
(the cell phone)
Your smartphone. You use this phone for everything, not the least of which is finding your way around. Only problem is that you lose it more often than you like. Luckily, you can track it from your computer back home, but it does make for some awkward conversations when your husband learns that your phone is halfway across the city. At least the password is easy to remember: it's the name of your daughter, Rachel.

You look out the window of the bar and see a taxi pull up. Better not keep the cabby waiting.

>s
Cab
A small cab, probably a couple decades old. The leather seats have peeled and been rubbed away, but they're more comfortable that way. The dashboard is mostly bare, except for a photo taped to the dash and a rosary hanging from the miror. You can see the back of the cabby's head through the glass, and his eyes through the rear mirror. There is a seat pocket in front of you.

You can see a photo, a rosary, a seat pocket (empty) and a cabby here.

You walk out of the bar and enter the cab. The driver doesn't turn around, but simply asks "Where to?" You give him your home address and sit back.

>put phone in pocket
You put the cell phone into the seat pocket.

>hit glass
Violence isn't the answer to this one.

Its probably going to be a long cab ride.

>x glass
A think pane of glass separates you from the front half of the cab.

>break glass
Violence isn't the answer to this one.

The cabbies usually don't take this road. Oh well, maybe there was traffic on the way here.

>hit cabby
Violence isn't the answer to this one.

>attack cabby
Violence isn't the answer to this one.

You're going completely the wrong way. You try to tell the cabby, but he doesn't say a word.

>scream
You must supply a noun.

>z
Time passes.

* * *

>talk to cabby
You question the cabby about his various motives and means of his kidnappings, but he either dodges the question, or just starts laughing.

>ask cabby about stuff
You can only do that to something animate.

>ask cabby
You question the cabby about his various motives and means of his kidnappings, but he either dodges the question, or just starts laughing.

The cabby seems to grow impatient. 
 "Now we're gonna play a little game, just the two of us. Look here, I got two bottles, each with a pill inside, identical in every way, cept one. One of the pills is harmless, and the other's got poison in it. I'm gonna put these bottles down, and you're gonna pick one, and take the pill inside, and I'll take the other, winner walks away alive." 

 He places the two identical bottles down onto the floor, and slides one toward you. 

 "Now, did I just give you the good bottle, or the bad bottle? I can tell you right now I'm gonna win, cause I know how people think. Now, make your move.

>x near bottle
A small clear bottle with a pink pill inside. It looks identical to its counterpart.

>open near bottle
You pick up the bottle closer to you, open it, and take the pill inside. At the same time, the cabby takes the other bottle and takes that pill. A few moments pass, and the cabby begins to laugh hysterically. You double over in pain, and the cabby stands up and starts to leave the room. 

 "I told ya, I always win. Sorry, love, but it won't be long now. But hey, thanks for making the cleanup so easy on me." 

 Your vision blurs as you collapse to the ground. You realize that these are probably your last moments. Your thoughts race, and you try to think of something, anything you can do. You see your hands on the floor, your nails are pretty sharp. You could probably carve something into the soft wooden floor. Maybe you can stop this sick bastard after all.

What will you carve into the ground?

1) The killer's name.
2) Your daughter's name.
3) Your husband's name.

>2
[Your daughter's name.]

In your last moments, your thoughts drift to your daughter. She never made it past the age of two, that's when the cancer got her. You painstakingly carve in "RACHEL" into the ground, and as your final breath leaves your lungs, you hope that you will see her soon.

You are Sherlock Holmes. Often times when a case looks particularly difficult, or when the local police force can't be bothered to do their jobs correctly, they call you in to provide some insight. While most of their "cases" rarely merit a second thought, this one intrigues you. A suicide, but so obviously not so, perplexing. You arrived onto the scene mere hours after the police discovered the body, and you get to begin the investigation before the Medical Examiner even arrived. One of the perks of having the chief detective inspector owe you a favor. Now it is just you and the murder. The game is afoot.

In your last moments, your thoughts drift to your daughter. She never made it past the age of two, that's when the cancer got her. You painstakingly carve in "RACHEL" into the ground, and as your final breath leaves your lungs, you hope that you will see her soon.

abandoned apartment
An old, run-down flat a few miles outside of London. Most of the wood is rotting or damp, or both. However, you did not come here to criticize the shortcomings of homeowners, you have a murder to solve.

You can see a corpse here.

>i
You are carrying nothing.

>go to Beth's house
You have no idea where that is

>go to hotel bar
Now why would you go there?

>go to void
Good try, clever one, but no.

* * *

>x television
The television behind the bar is currently showing an episode of one of those crime dramas where the woman gets kidnapped and killed after being utterly useless. Then the detective comes in and magically already knows all of the information about the case, and perfectly catches the killer on the first try. Never was your kind of show.

>x cocktail
Some fancy pink thing that you ordered about an hour ago, paid for with your hubby's credit card. It's not bad, just a bit sweet for your tastes.

>x matchbook
A tiny book of matches with the hotel's name on the front, "The Easton." Used for advertising. You might want to go out for a smoke later.

>take matchbook
Taken.

You look out the window of the bar and see a taxi pull up. Better not keep the cabby waiting.

>go out
Cab
A small cab, probably a couple decades old. The leather seats have peeled and been rubbed away, but they're more comfortable that way. The dashboard is mostly bare, except for a photo taped to the dash and a rosary hanging from the miror. You can see the back of the cabby's head through the glass, and his eyes through the rear mirror. There is a seat pocket in front of you.

You can see a photo, a rosary, a seat pocket (empty) and a cabby here.

You walk out of the bar and enter the cab. The driver doesn't turn around, but simply asks "Where to?" You give him your home address and sit back.

>x photo
An old polaroid picturing three people: a woman and two children. You imagine that this must be the cabby's family.

>x rosary
A rosary, looks old.

Its probably going to be a long cab ride.

>x seat pocket
A leather seat pocket attached to the seat in front of you.

>x cabby
From the little you've seen of the cabby, he looks pretty old. He's got gray hair and a wool cap. You can see wrinkles on his face through the rear mirror.

The cabbies usually don't take this road. Oh well, maybe there was traffic on the way here.

>talk to cappy
You can't see any such thing.

>talk to cabby
You don't really have much to say...

>get out of cab
I only understood you as far as wanting to get outside.

>get out
But you aren't in anything at the moment.

You're going completely the wrong way. You try to tell the cabby, but he doesn't say a word.

>cry
You cry out with all the air in your lungs but no one seems to notice...

>cry
You cry out with all the air in your lungs but no one seems to notice...

>cry
You cry out with all the air in your lungs but no one seems to notice...

You are starting to get very worried, the last street you recognized was three turns ago. You check your phone: no signal.

>cry
You cry out with all the air in your lungs but no one seems to notice...

>eat
What do you want to eat?

>the cabby
That's plainly inedible.

The cabby drives out to a street with a few abandoned buildings and pulls over. Think, Beth, think! You can't get out of the cab, your phone has no signal, is there anything that you can do?

>cry
You cry out with all the air in your lungs but no one seems to notice...

The cabby silently opens his side of the door, closes it, and opens the door on your side. You turn and kick him in the groin as soon as he opens the door. He doubles over for a moment, but recovers before you can strike again. 

 "Alright, we're going to have a little chat, you and I. But first..." 

 With speed that you did not expect, the cabby pulls out a syringe and jabs you in the neck with it. It only takes a few seconds before your vision goes dark.

abandoned apartment
A musty old room that you assume once was a living area of someone's flat, but it has been abandoned for so long that the wood has rotted, and time has put holes in the roof. The state of the room, however is the least of your concerns. There is a murderer right in front of you.

The cabby sits in front of you. He seems eerily calm about the whole situation. 
 "Wake up, sleepyhead. I told ya that we was gonna have a little chat, so here we are. Don't worry, I didn't do nothing else to ya, sides the sleepin medicine. Now, you're Beth, yeah? Don't matter. After all, you're gonna be dead in a few minutes." 

 You ask if he is going to kill you here, and he chuckles. 

 "Naw, I'm just gonna talk to ya, and then you're gonna kill yourself."

>attack cabby
Violence isn't the answer to this one.

>cry
You cry out with all the air in your lungs but no one seems to notice...

The cabby seems to grow impatient. 
 "Now we're gonna play a little game, just the two of us. Look here, I got two bottles, each with a pill inside, identical in every way, cept one. One of the pills is harmless, and the other's got poison in it. I'm gonna put these bottles down, and you're gonna pick one, and take the pill inside, and I'll take the other, winner walks away alive." 

 He places the two identical bottles down onto the floor, and slides one toward you. 

 "Now, did I just give you the good bottle, or the bad bottle? I can tell you right now I'm gonna win, cause I know how people think. Now, make your move.

>take pill
You can't see any such thing.

>take bottel
You can't see any such thing.

>take bottle
Which do you mean, the far bottle or the near bottle?

>near bottle
You pick up the bottle closer to you, open it, and take the pill inside. At the same time, the cabby takes the other bottle and takes that pill. A few moments pass, and the cabby begins to laugh hysterically. You double over in pain, and the cabby stands up and starts to leave the room. 

 "I told ya, I always win. Sorry, love, but it won't be long now. But hey, thanks for making the cleanup so easy on me." 

 Your vision blurs as you collapse to the ground. You realize that these are probably your last moments. Your thoughts race, and you try to think of something, anything you can do. You see your hands on the floor, your nails are pretty sharp. You could probably carve something into the soft wooden floor. Maybe you can stop this sick bastard after all.

What will you carve into the ground?

1) The killer's name.
2) Your daughter's name.
3) Your husband's name.

>1
[The killer's name.]

Of course! Writing the killer's name is a sure way to get them caught. You bring your hand onto the wood and realize that you never learned the name of the cabby. Not knowing what to write, you desperately try to think of something else, but your final breaths are spent in frustration, and nothing is written down.

You are Sherlock Holmes. Often times when a case looks particularly difficult, or when the local police force can't be bothered to do their jobs correctly, they call you in to provide some insight. While most of their "cases" rarely merit a second thought, this one intrigues you. A suicide, but so obviously not so, perplexing. You arrived onto the scene mere hours after the police discovered the body, and you get to begin the investigation before the Medical Examiner even arrived. One of the perks of having the chief detective inspector owe you a favor. Now it is just you and the murder. The game is afoot.

Of course! Writing the killer's name is a sure way to get them caught. You bring your hand onto the wood and realize that you never learned the name of the cabby. Not knowing what to write, you desperately try to think of something else, but your final breaths are spent in frustration, and nothing is written down.

abandoned apartment
An old, run-down flat a few miles outside of London. Most of the wood is rotting or damp, or both. However, you did not come here to criticize the shortcomings of homeowners, you have a murder to solve.

You can see a corpse and a matchbook here.

>x corpse
It appears that this poor lady met an unfortunate fate tonight. Worse news, the police haven't even had time to identify the body yet, so It's up to you to figure this out quickly. The killer seems to have taken anything off of the body that he deemed valuable or important. They are likely looking for an escape, and you ought to find them before they get away. 
One interesting thing you find, however is that her fingers look ragged, and there are some scratches on the floor next to her hand.

There are some scrawlings on the ground, some look like letters, but others seem purely illegible. Either way, you can't make out what it is supposed to say.

>x letters
You can't see any such thing.

>x matchbook
A small book of matches, unused. There is a hotel's name on the side: the Easton.

It's not much, but it's a lead. You might as well go and check out the hotel bar and see if you can figure out who this woman was. 

 HINT: Use "go to" to move from place to place as Sherlock

>go to the Easton
That noun did not make sense in this context.

>go to Easton
That noun did not make sense in this context.

>Go to Easton
That noun did not make sense in this context.

>go to hotel
Hotel Bar
The hotel bar of some high-class hotel on the south side of London: The Easton. Given that it's still the middle of the night, no one else is here, save for the bartender.

You can see a television, a decorative bowl (empty) and a bartender here.

>x bartender
The sleepy bartender has all but cleaned up for the night. You figure that the only reason he's still awake is because you are here.

>ask bartender
You approach the bartender and tell him about the murder case. You ask if he has seen a woman in the bar earlier this evening. 
 "A woman? I see dozens of people, men and women, every single night down here, never the same. I might be able to help you if I had a little more information. Sorry."

>cry
That would just be loud and pointless.

>x television
The television in the hotel is currently off. Doesn't really matter either way, you never really liked watching anything, so predictable.

>x bowl
A small bowl that probably used to contain a bunch of matchbooks offered complimentary to patrons.

>x matchbook
You can't see any such thing.

>z
Time passes.

* * *

>z
Time passes.

    *** The matchbook was a promising lead, but it seems to be a dead end. After fumbling around the hotel bar for a while, you realize that there is no more information to be found here. If only there was a way to find her name. And without any more leads to follow, you return to the detective inspector with your bad news. The killer is likely to get away by morning.

 Try again! There must be some way to learn the victim's name... ***

Would you like to RESTART, RESTORE a saved game, QUIT or UNDO the last command?

>z
Please give one of the answers above.

Would you like to RESTART, RESTORE a saved game, QUIT or UNDO the last command?

>retart
Please give one of the answers above.

Would you like to RESTART, RESTORE a saved game, QUIT or UNDO the last command?

>resart
Please give one of the answers above.

Would you like to RESTART, RESTORE a saved game, QUIT or UNDO the last command?

>[tab]RESTART
Please give one of the answers above.

Would you like to RESTART, RESTORE a saved game, QUIT or UNDO the last command?

>restart
WARNING: This game is going to be difficult, and will likely require multiple playthroughs in order to reach a successful outcome, unless you are incredibly clever. You must learn from your mistakes in the past to secure the future. The game is afoot! 

You are Beth Davenport, an official at the Ministry of Transport, but that is not the important part of the story. You are out at a hotel on the south side of London, hoping to find a weary businessman to make the night less lonely, but your husband doesn't know that. You have been sitting at the bar for a few hours now, and with no prospects in sight, you are feeling that you might just be better off going home. You called a cab a few minutes ago, and it should be getting here in a few minutes.

The Pink Pill
An Interactive Fiction by Ryan
Release 1 / Serial number 180511 / Inform 7 build 6M62 (I6/v6.33 lib 6/12N) SD

Hotel Bar
The hotel bar on the first floor of some gaudy hotel that you have forgotten the name of. It's not important anyways. After all, you're not going to be paying for a room tonight. At least, that was your plan. Not many people here tonight, just the bartender and some lonely chairs. The exit is to the south.

You can see a television, a cocktail, a decorative bowl (in which is a matchbook) and a bartender here.

>take matchbook
Taken.

>drink cocktail
You take one sip and remember why you havent finished it yet. You put it back on the table.

>x bartender
The bartender stands down the bar. He looks like he's cleaning up for the night, you're one of the last people here. You thought about chatting him up, but he's not really your type, and you've been here enough that he knows you by name. At least he's nice.

>s
You have no where to go. Better wait here until your cab arrives.

You look out the window of the bar and see a taxi pull up. Better not keep the cabby waiting.

>help
I didn't understand that sentence.

>cry
You cry out with all the air in your lungs but no one seems to notice...

>go to cab
You have no way to get there at the moment.

I beg your pardon?

>RESTART
Are you sure you want to restart?

>yes
WARNING: This game is going to be difficult, and will likely require multiple playthroughs in order to reach a successful outcome, unless you are incredibly clever. You must learn from your mistakes in the past to secure the future. The game is afoot! 

You are Beth Davenport, an official at the Ministry of Transport, but that is not the important part of the story. You are out at a hotel on the south side of London, hoping to find a weary businessman to make the night less lonely, but your husband doesn't know that. You have been sitting at the bar for a few hours now, and with no prospects in sight, you are feeling that you might just be better off going home. You called a cab a few minutes ago, and it should be getting here in a few minutes.

The Pink Pill
An Interactive Fiction by Ryan
Release 1 / Serial number 180511 / Inform 7 build 6M62 (I6/v6.33 lib 6/12N) SD

Hotel Bar
The hotel bar on the first floor of some gaudy hotel that you have forgotten the name of. It's not important anyways. After all, you're not going to be paying for a room tonight. At least, that was your plan. Not many people here tonight, just the bartender and some lonely chairs. The exit is to the south.

You can see a television, a cocktail, a decorative bowl (in which is a matchbook) and a bartender here.

>x television
The television behind the bar is currently showing an episode of one of those crime dramas where the woman gets kidnapped and killed after being utterly useless. Then the detective comes in and magically already knows all of the information about the case, and perfectly catches the killer on the first try. Never was your kind of show.

>drink coctail
You can't see any such thing.

>drink cocktail
You take one sip and remember why you havent finished it yet. You put it back on the table.

>x bowl
A small bowl that probably used to contain a bunch of matchbooks offered complimentary to patrons.

In the decorative bowl is a matchbook.

>take matchbook
Taken.

You look out the window of the bar and see a taxi pull up. Better not keep the cabby waiting.

>x taxi
You can't see any such thing.

>s
Cab
A small cab, probably a couple decades old. The leather seats have peeled and been rubbed away, but they're more comfortable that way. The dashboard is mostly bare, except for a photo taped to the dash and a rosary hanging from the miror. You can see the back of the cabby's head through the glass, and his eyes through the rear mirror. There is a seat pocket in front of you.

You can see a photo, a rosary, a seat pocket (empty) and a cabby here.

You walk out of the bar and enter the cab. The driver doesn't turn around, but simply asks "Where to?" You give him your home address and sit back.

* * *

>x photo
An old polaroid picturing three people: a woman and two children. You imagine that this must be the cabby's family.

>take photo
The pane of plexiglass separates you from the front half of the cab.

Its probably going to be a long cab ride.

>x rosary
A rosary, looks old.

* * *

>take rosary
The pane of plexiglass separates you from the front half of the cab.

The cabbies usually don't take this road. Oh well, maybe there was traffic on the way here.

>x taxi driver
You can't see any such thing.

>x road
You can't see any such thing.

>x driver
You can't see any such thing.

>talk to driveer
You can't see any such thing.

>talk to driver
You can't see any such thing.

>x seat pocket
A leather seat pocket attached to the seat in front of you.

>open pocket
It isn't something you can open.

You're going completely the wrong way. You try to tell the cabby, but he doesn't say a word.

>exit taxi
I only understood you as far as wanting to exit.

>x cabby
From the little you've seen of the cabby, he looks pretty old. He's got gray hair and a wool cap. You can see wrinkles on his face through the rear mirror.

>talk to cabby
You don't really have much to say...

>ask cabby to stop
You can only do that to something animate.

>hit glass
Violence isn't the answer to this one.

You are starting to get very worried, the last street you recognized was three turns ago. You check your phone: no signal.

>put rosary in seat pocket
(first taking the rosary)
The pane of plexiglass separates you from the front half of the cab.

>hit cabby
Violence isn't the answer to this one.

>put picture in seat pocket
You can't see any such thing.

>put photo in seat pocket
(first taking the photo)
The pane of plexiglass separates you from the front half of the cab.

The cabby drives out to a street with a few abandoned buildings and pulls over. Think, Beth, think! You can't get out of the cab, your phone has no signal, is there anything that you can do?

>open door
You can't see any such thing.

>x phone
Your smartphone. You use this phone for everything, not the least of which is finding your way around. Only problem is that you lose it more often than you like. Luckily, you can track it from your computer back home, but it does make for some awkward conversations when your husband learns that your phone is halfway across the city. At least the password is easy to remember: it's the name of your daughter, Rachel.

The cabby silently opens his side of the door, closes it, and opens the door on your side. You turn and kick him in the groin as soon as he opens the door. He doubles over for a moment, but recovers before you can strike again. 

 "Alright, we're going to have a little chat, you and I. But first..." 

 With speed that you did not expect, the cabby pulls out a syringe and jabs you in the neck with it. It only takes a few seconds before your vision goes dark.

abandoned apartment
A musty old room that you assume once was a living area of someone's flat, but it has been abandoned for so long that the wood has rotted, and time has put holes in the roof. The state of the room, however is the least of your concerns. There is a murderer right in front of you.

The cabby sits in front of you. He seems eerily calm about the whole situation. 
 "Wake up, sleepyhead. I told ya that we was gonna have a little chat, so here we are. Don't worry, I didn't do nothing else to ya, sides the sleepin medicine. Now, you're Beth, yeah? Don't matter. After all, you're gonna be dead in a few minutes." 

 You ask if he is going to kill you here, and he chuckles. 

 "Naw, I'm just gonna talk to ya, and then you're gonna kill yourself."

>talk to cabby
You question the cabby about his various motives and means of his kidnappings, but he either dodges the question, or just starts laughing.

>hit cabby
Violence isn't the answer to this one.

The cabby seems to grow impatient. 
 "Now we're gonna play a little game, just the two of us. Look here, I got two bottles, each with a pill inside, identical in every way, cept one. One of the pills is harmless, and the other's got poison in it. I'm gonna put these bottles down, and you're gonna pick one, and take the pill inside, and I'll take the other, winner walks away alive." 

 He places the two identical bottles down onto the floor, and slides one toward you. 

 "Now, did I just give you the good bottle, or the bad bottle? I can tell you right now I'm gonna win, cause I know how people think. Now, make your move.

>take bottle
Which do you mean, the far bottle or the near bottle?

>take near bottle
You pick up the bottle closer to you, open it, and take the pill inside. At the same time, the cabby takes the other bottle and takes that pill. A few moments pass, and the cabby begins to laugh hysterically. You double over in pain, and the cabby stands up and starts to leave the room. 

 "I told ya, I always win. Sorry, love, but it won't be long now. But hey, thanks for making the cleanup so easy on me." 

 Your vision blurs as you collapse to the ground. You realize that these are probably your last moments. Your thoughts race, and you try to think of something, anything you can do. You see your hands on the floor, your nails are pretty sharp. You could probably carve something into the soft wooden floor. Maybe you can stop this sick bastard after all.

What will you carve into the ground?

1) The killer's name.
2) Your daughter's name.
3) Your husband's name.

>1
[The killer's name.]

Of course! Writing the killer's name is a sure way to get them caught. You bring your hand onto the wood and realize that you never learned the name of the cabby. Not knowing what to write, you desperately try to think of something else, but your final breaths are spent in frustration, and nothing is written down.

You are Sherlock Holmes. Often times when a case looks particularly difficult, or when the local police force can't be bothered to do their jobs correctly, they call you in to provide some insight. While most of their "cases" rarely merit a second thought, this one intrigues you. A suicide, but so obviously not so, perplexing. You arrived onto the scene mere hours after the police discovered the body, and you get to begin the investigation before the Medical Examiner even arrived. One of the perks of having the chief detective inspector owe you a favor. Now it is just you and the murder. The game is afoot.

Of course! Writing the killer's name is a sure way to get them caught. You bring your hand onto the wood and realize that you never learned the name of the cabby. Not knowing what to write, you desperately try to think of something else, but your final breaths are spent in frustration, and nothing is written down.

abandoned apartment
An old, run-down flat a few miles outside of London. Most of the wood is rotting or damp, or both. However, you did not come here to criticize the shortcomings of homeowners, you have a murder to solve.

You can see a corpse and a matchbook here.

* * *

>take matchbook
Taken.

>x matchbook
A small book of matches, unused. There is a hotel's name on the side: the Easton.

It's not much, but it's a lead. You might as well go and check out the hotel bar and see if you can figure out who this woman was. 

 HINT: Use "go to" to move from place to place as Sherlock

>go to hotel bar
Hotel Bar
The hotel bar of some high-class hotel on the south side of London: The Easton. Given that it's still the middle of the night, no one else is here, save for the bartender.

You can see a television, a decorative bowl (empty) and a bartender here.

>x bartender
The sleepy bartender has all but cleaned up for the night. You figure that the only reason he's still awake is because you are here.

>talk to bartender
You approach the bartender and tell him about the murder case. You ask if he has seen a woman in the bar earlier this evening. 
 "A woman? I see dozens of people, men and women, every single night down here, never the same. I might be able to help you if I had a little more information. Sorry."

>n
You can't go that way.

>s
You can't go that way.

>x matchbook
A small book of matches, unused. There is a hotel's name on the side: the Easton.

It's not much, but it's a lead. You might as well go and check out the hotel bar and see if you can figure out who this woman was. 

 HINT: Use "go to" to move from place to place as Sherlock

>go to apartment
abandoned apartment
An old, run-down flat a few miles outside of London. Most of the wood is rotting or damp, or both. However, you did not come here to criticize the shortcomings of homeowners, you have a murder to solve.

You can see a corpse here.

>x corpse
It appears that this poor lady met an unfortunate fate tonight. Worse news, the police haven't even had time to identify the body yet, so It's up to you to figure this out quickly. The killer seems to have taken anything off of the body that he deemed valuable or important. They are likely looking for an escape, and you ought to find them before they get away. 
One interesting thing you find, however is that her fingers look ragged, and there are some scratches on the floor next to her hand.

There are some scrawlings on the ground, some look like letters, but others seem purely illegible. Either way, you can't make out what it is supposed to say.

>x scrawlings
You can't see any such thing.

>x corpse
It appears that this poor lady met an unfortunate fate tonight. Worse news, the police haven't even had time to identify the body yet, so It's up to you to figure this out quickly. The killer seems to have taken anything off of the body that he deemed valuable or important. They are likely looking for an escape, and you ought to find them before they get away. 
One interesting thing you find, however is that her fingers look ragged, and there are some scratches on the floor next to her hand.

There are some scrawlings on the ground, some look like letters, but others seem purely illegible. Either way, you can't make out what it is supposed to say.

>x hand
You can't see any such thing.

>restart
Are you sure you want to restart?

>yes
WARNING: This game is going to be difficult, and will likely require multiple playthroughs in order to reach a successful outcome, unless you are incredibly clever. You must learn from your mistakes in the past to secure the future. The game is afoot! 

You are Beth Davenport, an official at the Ministry of Transport, but that is not the important part of the story. You are out at a hotel on the south side of London, hoping to find a weary businessman to make the night less lonely, but your husband doesn't know that. You have been sitting at the bar for a few hours now, and with no prospects in sight, you are feeling that you might just be better off going home. You called a cab a few minutes ago, and it should be getting here in a few minutes.

The Pink Pill
An Interactive Fiction by Ryan
Release 1 / Serial number 180511 / Inform 7 build 6M62 (I6/v6.33 lib 6/12N) SD

Hotel Bar
The hotel bar on the first floor of some gaudy hotel that you have forgotten the name of. It's not important anyways. After all, you're not going to be paying for a room tonight. At least, that was your plan. Not many people here tonight, just the bartender and some lonely chairs. The exit is to the south.

You can see a television, a cocktail, a decorative bowl (in which is a matchbook) and a bartender here.

* * *

>drink cocktail
You take one sip and remember why you havent finished it yet. You put it back on the table.

>take matchbook
Taken.

* * *

>drop ring
Dropped.

>z
Time passes.

You look out the window of the bar and see a taxi pull up. Better not keep the cabby waiting.

* * *

>put phone in pocket
You put the cell phone into the seat pocket.

>break glass
Violence isn't the answer to this one.

Its probably going to be a long cab ride.

>open door
You can't see any such thing.

>leave cab
I only understood you as far as wanting to leave.

>leave
But you aren't in anything at the moment.

>exit
But you aren't in anything at the moment.

The cabbies usually don't take this road. Oh well, maybe there was traffic on the way here.

>z
Time passes.

* * *

>i
You are carrying:
  a matchbook

>z
Time passes.

The cabby seems to grow impatient. 
 "Now we're gonna play a little game, just the two of us. Look here, I got two bottles, each with a pill inside, identical in every way, cept one. One of the pills is harmless, and the other's got poison in it. I'm gonna put these bottles down, and you're gonna pick one, and take the pill inside, and I'll take the other, winner walks away alive." 

 He places the two identical bottles down onto the floor, and slides one toward you. 

 "Now, did I just give you the good bottle, or the bad bottle? I can tell you right now I'm gonna win, cause I know how people think. Now, make your move.

>open far bottle
You pick up the bottle farther away from you, open it, and take the pill inside. At the same time, the cabby takes the other bottle and takes that pill. A few moments pass, and the cabby begins to laugh hysterically. You double over in pain, and the cabby stands up and starts to leave the room. 

 "I told ya, I always win. Sorry, love, but it won't be long now. But hey, thanks for making the cleanup so easy on me." 

 Your vision blurs as you collapse to the ground. You realize that these are probably your last moments. Your thoughts race, and you try to think of something, anything you can do. You see your hands on the floor, your nails are pretty sharp. You could probably carve something into the soft wooden floor. Maybe you can stop this sick bastard after all.

What will you carve into the ground?

1) The killer's name.
2) Your daughter's name.
3) Your husband's name.

>2
[Your daughter's name.]

In your last moments, your thoughts drift to your daughter. She never made it past the age of two, that's when the cancer got her. You painstakingly carve in "RACHEL" into the ground, and as your final breath leaves your lungs, you hope that you will see her soon.

You are Sherlock Holmes. Often times when a case looks particularly difficult, or when the local police force can't be bothered to do their jobs correctly, they call you in to provide some insight. While most of their "cases" rarely merit a second thought, this one intrigues you. A suicide, but so obviously not so, perplexing. You arrived onto the scene mere hours after the police discovered the body, and you get to begin the investigation before the Medical Examiner even arrived. One of the perks of having the chief detective inspector owe you a favor. Now it is just you and the murder. The game is afoot.

In your last moments, your thoughts drift to your daughter. She never made it past the age of two, that's when the cancer got her. You painstakingly carve in "RACHEL" into the ground, and as your final breath leaves your lungs, you hope that you will see her soon.

abandoned apartment
An old, run-down flat a few miles outside of London. Most of the wood is rotting or damp, or both. However, you did not come here to criticize the shortcomings of homeowners, you have a murder to solve.

You can see a corpse and a matchbook here.

>x matchbook
A small book of matches, unused. There is a hotel's name on the side: the Easton.

It's not much, but it's a lead. You might as well go and check out the hotel bar and see if you can figure out who this woman was. 

 HINT: Use "go to" to move from place to place as Sherlock

>go to hotel bar
Hotel Bar
The hotel bar of some high-class hotel on the south side of London: The Easton. Given that it's still the middle of the night, no one else is here, save for the bartender.

You can see a wedding ring, a television, a decorative bowl (empty) and a bartender here.

>x ring
A simple wedding ring with a diamond embedded into it. upon closer inspection, you see that there are two names engraved on the inside of it.

This wedding ring likely belonged to the victim. Her name was Beth. She was clever, leaving the wedding ring here, where she knew that it wouldn't be discarded, and who would steal an engraved wedding ring? Perhaps the bartender can give you some more information now that you have a couple of names.

* * *

>z
Time passes.

* * *

>z
Time passes.

Its probably going to be a long cab ride.

I beg your pardon?

* * *

>take far bottle
You pick up the bottle farther away from you, open it, and take the pill inside. At the same time, the cabby takes the other bottle and takes that pill. A few moments pass, and the cabby begins to laugh hysterically. You double over in pain, and the cabby stands up and starts to leave the room. 

 "I told ya, I always win. Sorry, love, but it won't be long now. But hey, thanks for making the cleanup so easy on me." 

 Your vision blurs as you collapse to the ground. You realize that these are probably your last moments. Your thoughts race, and you try to think of something, anything you can do. You see your hands on the floor, your nails are pretty sharp. You could probably carve something into the soft wooden floor. Maybe you can stop this sick bastard after all.

What will you carve into the ground?

1) The killer's name.
2) Your daughter's name.
3) Your husband's name.

>2
[Your daughter's name.]

In your last moments, your thoughts drift to your daughter. She never made it past the age of two, that's when the cancer got her. You painstakingly carve in "RACHEL" into the ground, and as your final breath leaves your lungs, you hope that you will see her soon.

You are Sherlock Holmes. Often times when a case looks particularly difficult, or when the local police force can't be bothered to do their jobs correctly, they call you in to provide some insight. While most of their "cases" rarely merit a second thought, this one intrigues you. A suicide, but so obviously not so, perplexing. You arrived onto the scene mere hours after the police discovered the body, and you get to begin the investigation before the Medical Examiner even arrived. One of the perks of having the chief detective inspector owe you a favor. Now it is just you and the murder. The game is afoot.

In your last moments, your thoughts drift to your daughter. She never made it past the age of two, that's when the cancer got her. You painstakingly carve in "RACHEL" into the ground, and as your final breath leaves your lungs, you hope that you will see her soon.

void
You shouldn't have been able to get here...

You can see a far bottle, a near bottle, a cabby and a cocktail here.

>x self
You are Sherlock Holmes. Often times when a case looks particularly difficult, or when the local police force can't be bothered to do their jobs correctly, they call you in to provide some insight. While most of their "cases" rarely merit a second thought, this one intrigues you. A suicide, but so obviously not so, perplexing. You arrived onto the scene mere hours after the police discovered the body, and you get to begin the investigation before the Medical Examiner even arrived. One of the perks of having the chief detective inspector owe you a favor. Now it is just you and the murder. The game is afoot.