You wake up in your smal room on a quiet Sunday morning, or at least it would be, if your deadline wasn't in two days. The gallery is opening Friday, and you havent even started on your painting to be showcased. You get out of bed, make yourself a cup of coffee, and head down to your art room for the day. Who knows? Maybe inspiration will find you today...

Artist's Block
An Interactive Fiction by Ryan
Release 1 / Serial number 180214 / Inform 7 build 6M62 (I6/v6.33 lib 6/12N) SD

Studio
Your art studio. This is where the magic happens. Many a masterpiece, and many more pieces of garbage have all been created in this very room. All of your necessary supplies are in their normal places.

You can see a couch (on which is a dog), a side table (on which are a bowl (in which is an apple) and a letter) and an easel (on which are a canvas and a paintbrush) here.

>x easel
Your reliable easel. It holds up the canvas and paint while you create works of art.

On the easel are a canvas and a paintbrush.

>take canvas
That's fixed in place.

>x canvas
Ah, the canvas. Your best friend on some days, your worst enemy on others. It gives you a blank stare that seems to tell you that it is feeling particularly dificult today.

>x paintbrush
The trusty paintbrush. Your vehicle from which you put your thoughts into art.

>paint
You must supply a noun.

>paint canvas
You must supply a noun.

>take paintbrush
Taken.

>pain
That's not a verb I recognise.

>paint
You must supply a noun.

* * *

>take paintbrush
Taken.

>drop paintbrush
Dropped.

>paint
You haven't tried finger painting since middle school. You much prefer using the paintbrush.

>take paintbrush
Taken.

>paint
*** Truly inspired, you let your hand dance across the canvas to create a beautiful work of art. You feel accomplished, and proud of what you have created. ***

Would you like to RESTART, RESTORE a saved game, QUIT or UNDO the last command?

>restart
Artist's Block
An Interactive Fiction by Ryan
Release 1 / Serial number 180205 / Inform 7 build 6M62 (I6/v6.33 lib 6/12N) SD

Studio
Your art studio. This is where the magic happens. Many a masterpiece, and many more pieces of garbage have all been created in this very room. All of your necessary supplies are in their normal places.

You can see an easel (on which are a canvas and a paintbrush) here.

>take paintbrush
Taken.

>paint canvas
*** Truly inspired, you let your hand dance across the canvas to create a beautiful work of art. You feel accomplished, and proud of what you have created. ***

Would you like to RESTART, RESTORE a saved game, QUIT or UNDO the last command?

>restart
Artist's Block
An Interactive Fiction by Ryan
Release 1 / Serial number 180205 / Inform 7 build 6M62 (I6/v6.33 lib 6/12N) SD

Studio
Your art studio. This is where the magic happens. Many a masterpiece, and many more pieces of garbage have all been created in this very room. All of your necessary supplies are in their normal places.

You can see an easel (on which are a canvas and a paintbrush) here.

* * *

>take paintbrush
Taken.

>paint dog
I only understood you as far as wanting to paint.

>look
Studio
Your art studio. This is where the magic happens. Many a masterpiece, and many more pieces of garbage have all been created in this very room. All of your necessary supplies are in their normal places.

You can see an easel (on which is a canvas) here.

>paint
*** Truly inspired, you let your hand dance across the canvas to create a beautiful work of art. You feel accomplished, and proud of what you have created. ***

Would you like to RESTART, RESTORE a saved game, QUIT or UNDO the last command?

* * *

>paint
You sit for an hour staring down the blank canvas, but nothing is coming to you. Your eyes are starting to hurt, and you are just getting frustrated at this point. One thing is obvious, though. Sitting here is getting you nowhere.

You haven't tried finger painting since middle school. You much prefer using the paintbrush.

* * *

>x bowl
A bowl of apples. Pretty, but you've never been much for painting fruit. Too cliche. The apple looks tasty, though.

In the bowl is an apple.

>take apple
Taken.

>eat apple
Well, at least you aren't hungry anymore. Now, back to painting.

>enter bowl
You get into the bowl.

* * *

>x dog
It's Peanut, your beagle that you've had ever since you moved to New York. You remember the first day that your parents brought Peanut home. You spent hours in the backyard trying to pick her up, but she was so fast. You ended up falling asleep on the front porch with her in your arms. You remember that it was one of the happiest days of your life. Suddenly, inspiration strikes you. The yard, a little puppy, a child chasing her, it's perfect! This is exactly what you need to finish your work for the gallery!

>x dog
No time to waste now, you've got the perfect idea and who knows how long it will last. Sorry, Peanut, your walk is going to have to wait.

>paint
You haven't tried finger painting since middle school. You much prefer using the paintbrush.

* * *

>take paintbrush
Taken.

>paint
*** Truly inspired, you let your hand dance across the canvas to create a beautiful work of art. You feel accomplished, and proud of what you have created. The gallery is going to love this! ***

Would you like to RESTART, RESTORE a saved game, QUIT or UNDO the last command?

* * *

>sit on couch
You get onto the couch.

On the couch you can see a dog.

>talk to dog
That's not a verb I recognise.

>take dog
Taken.

>read letter
It looks like a letter from Grandma. You open it up and start reading it. She just came back from winter in Florida with Gramps. She tells you about the beach and how your favorite tree that you climbed when you were a kid is still there. You remember splashing in the shallow parts of the water and flying your kite while your parents sat in the beach chairs a few feet away, sipping drinks without a care in the world. 

 Suddenly, inspiration strikes you. The beach chairs, the waves, the setting sun on the water, it's perfect! This is exactly what you need for the gallery!

>go to easel
You can't see any such thing.

>paint
You haven't tried finger painting since middle school. You much prefer using the paintbrush.

>paint with paintbrush
I only understood you as far as wanting to paint.

>paint on canvas
I only understood you as far as wanting to paint.

>paint on easel
I only understood you as far as wanting to paint.

>eat apple
(first taking the apple)
Well, at least you aren't hungry anymore. Now, back to painting.

>paint something
I only understood you as far as wanting to paint.

>take paintbrush
Taken.

>paint with paintbrush
I only understood you as far as wanting to paint.

>paint
*** Truly inspired, you let your hand dance across the canvas to create a beautiful work of art. You feel accomplished, and proud of what you have created. The gallery is going to love this! ***

Would you like to RESTART, RESTORE a saved game, QUIT or UNDO the last command?